傲然	aorj
安歇	anxp
矮了	aile
隘口	aikz
艾灸	aijq
阿嚏	aati
阿訇	aahs
阿公	aags
阿伯	aabd
北疆	bwjl
备货	bwho
北伐	bwfa
北段	bwdr
布阵	buvf
步态	butd
不俗	busu
布控	buks
步调	budn
博鳌	boao
表姨	bnyi
表婶	bnuj
标间	bnjm
标号	bnhc
冰柱	bkvu
冰凌	bklk
冰晶	bkjk
冰寒	bkhj
兵符	bkfu
兵丁	bkdk
办卡	bjka
笔筒	bits
笔谈	bitj
必考	bikc
壁橱	biiu
闭环	bihr
壁挂	bigx
鼻窦	bidz
绑腿	bhtv
柏油	bdyz
白猫	bdmc
包退	bctv
八两	ball
翠微	cvww
醋味	cuww
残影	cjyk
残雪	cjxt
此列	cilp
此话	cihx
此行	cihh
蹭吃	cgii
蹭车	cgie
菜品	cdpb
菜农	cdns
彩灯	cddg
漕运	ccyy
擦药	cayc
擦鞋	caxp
擦手	cauz
擦脸	calm
擦脚	cajn
钝化	dyhx
堵心	duxb
肚痛	duts
肚兜	dudz
东段	dsdr
端木	drmu
吊索	dnso
电箱	dmxl
垫圈	dmjr
颠沛	dmpw
点开	dmkd
电柜	dmgv
电工	dmgs
点错	dmco
盯死	dksi
顶楼	dklz
顶灯	dkdg
单边	djbm
灯箱	dgxl
等边	dgbm
倒桩	dcvl
捯饬	dcii
到付	dcfu
大仙	daxm
鸟样	dnyh
鸟窝	dnwo
鸟兽	dnuz
鸟枪	dnql
鸟粪	dnff
调仓	dnch
追兵	dvbk
二回	erhv
赴美	fumw
父老	fulc
复查	fuia
伏虎	fuhu
番邦	fjbh
房前	fhqm
防霉	fhmw
放浪	fhlh
防臭	fhiz
方管	fhgr
蜂王	fgwh
分针	ffvf
法兰	falj
发件	fajm
苟安	gzan
挂掉	gxdn
贡品	gspb
公粮	gsll
共处	gsiu
功过	gsgo
宫娥	gsee
工段	gsdr
关东	grds
过站	govj
果糖	goth
果酒	gojq
光秃	gltu
甘休	gjxq
干才	gjcd
隔间	gejm
改选	gdxr
高一	gcyi
高三	gcsj
高冷	gclg
高工	gcgs
高二	gcer
涡轮	goly
后仰	hzyh
候诊	hzvf
后山	hzuj
混搭	hyda
花猪	hxvu
滑腻	hxni
黑猫	hwmc
会审	hvuf
回踩	hvcd
户名	humk
湖景	hujk
哄着	hsvc
红楼	hslz
红椒	hsjn
换组	hrzu
换回	hrhv
货单	hodj
汉唐	hjth
哼哈	hgha
狠话	hfhx
菏泽	heze
海角	hdjn
海景	hdjk
好脏	hczh
好乱	hclr
好假	hcjx
行吗	hhma
臭嘴	izzv
筹拍	izpd
瞅瞅	iziz
初心	iuxb
除开	iukd
初春	iuiy
出格	iuge
冲茶	isia
虫害	ishd
串场	irih
吃些	iiso
吃香	iixl
常德	ihde
唱本	ihbf
撑伞	igsj
撑杆	iggj
承德	igde
趁手	ifuz
尘垢	ifgz
车龄	ielk
撤防	iefh
超卓	icvo
茶社	iaue
叉车	iaie
长草	ihcc
家宴	jxyj
佳酿	jxnl
假寐	jxmw
加急	jxji
家传	jxir
甲等	jxdg
剧作	juzo
居后	juhz
拒付	jufu
矍铄	jtuo
涓涓	jrjr
久闻	jqwf
解绑	jpbh
骄纵	jnzs
交投	jntz
箭镞	jmzu
健硕	jmuo
检票	jmpn
键帽	jmmc
间或	jmho
减分	jmff
见底	jmdi
将至	jlvi
姜蒜	jlsr
匠人	jlrf
讲求	jlqq
降格	jlge
降幅	jlfu
精油	jkyz
经用	jkys
敬重	jkis
竞速	jksu
击杀	jiua
积弱	jiro
荠菜	jicd
进项	jbxl
近看	jbkj
金叉	jbia
金贵	jbgv
金发	jbfa
禁播	jbbo
圈点	jrdm
降龙	jlls
捆扎	kyva
溃散	kvsj
酷炫	kuxr
苦荞	kuqn
控油	ksyz
空港	ksgh
扩增	kozg
狂泻	klxp
矿难	klnj
矿脉	klmd
块垒	kklw
看去	kjqu
砍价	kjjp
看房	kjfh
坑杀	kgua
开走	kdzz
开在	kdzd
开锁	kdso
开年	kdnm
开列	kdlp
开练	kdlm
开卡	kdka
开吃	kdii
开单	kddj
开打	kdda
开错	kdco
开标	kdbn
靠枕	kcvf
楼市	lzui
漏光	lzgl
轮毂	lygu
轮渡	lydu
滤网	lvwh
露台	lutd
卤菜	lucd
陇西	lsxi
留情	lqqk
留点	lqdm
列宁	lpnk
列明	lpmk
裸婚	lohy
连坐	lmzo
恋战	lmvj
连个	lmge
两座	llzo
粮荒	llhl
两栋	llds
良多	lldo
零上	lkuh
领路	lklu
揽活	ljho
利齿	liii
梨花	lihx
愣住	lgvu
愣是	lgui
冷噤	lgjb
楞逼	lgbi
来袭	ldxi
老妹	lcmw
老豆	lcdz
临沂	lbyi
邻县	lbxm
临空	lbks
拉直	lavi
拉丝	lasi
拉杆	lagj
梅雨	mwyu
幕府	mufu
磨破	mopo
磨具	moju
漠北	mobw
名将	mkjl
命长	mkih
命大	mkda
满地	mjde
米线	mixm
迷瞪	midg
忙完	mhwj
忙死	mhsi
门墙	mfql
门框	mfkl
闷棍	mfgy
买账	mdvh
埋汰	mdtd
麦苗	mdmn
卖萌	mdmg
毛肚	mcdu
民乐	mblc
马贼	mazw
马奶	mand
骂名	mamk
无糖	moth
无重	mois
内框	nwkl
内角	nwjn
农用	nsys
农闲	nsxm
农舍	nsue
农奴	nsnu
农贸	nsmc
农垦	nskf
农户	nshu
农耕	nsgg
暖床	nril
扭力	nqli
扭矩	nqju
牛叉	nqia
啮合	npge
诺诺	nono
尿片	nnpm
年尾	nmww
年节	nmjp
宁日	nkri
男神	njuf
南疆	najl
逆子	nizi
霓裳	niih
囔囔	nhnh
嫩滑	nfhx
奶瓶	ndpk
脑梗	ncgg
哪像	naxl
拿铁	natp
纳凉	nall
那届	najp
那般	nabj
偶一	ouyi
区块	oukk
赔笑	pwxn
配饰	pwui
培根	pwgf
普贤	puxm
莆田	putm
颇能	pong
破洞	pods
飘雨	pnyu
票证	pnvg
偏下	pmxx
偏小	pmxn
偏上	pmuh
偏少	pmuc
偏弱	pmro
偏强	pmjl
片场	pmih
偏低	pmdi
偏不	pmbu
平顺	pkuy
攀折	pjue
攀爬	pjpa
盘后	pjhz
皮草	picc
胖瘦	phuz
胖妞	phnq
喷绘	pfhv
牌桌	pdvo
泡茶	pcia
跑调	pcdn
拼单	pbdj
怕累	palw
怕苦	paku
曲直	quvi
屈身	quuf
屈伸	quuf
曲牌	qupd
取货	quho
缺水	qtuv
却能	qtng
泉州	qrvz
全日	qrri
全清	qrqk
全篇	qrpm
全款	qrkr
全看	qrkj
全靠	qrkc
囚牢	qqlc
秋葵	qqkv
切切	qpqp
切莫	qpmo
巧了	qnle
桥段	qndr
前山	qmuj
签批	qmpi
青烟	qkyj
倾销	qkxn
青山	qkuj
清退	qktv
清汤	qkth
青梅	qkmw
清流	qklq
青瓜	qkgx
轻轨	qkgv
情分	qkff
契约	qiyc
七旬	qixy
岂会	qihv
起锅	qigo
汽灯	qidg
肉馅	rzxm
柔性	rzxk
肉排	rzpd
入学	ruxt
入坑	rukg
容让	rsrh
荣光	rsgl
弱碱	rojm
日结	rijp
仍可	rgke
人脉	rfmd
认路	rflu
认了	rfle
忍了	rfle
热饮	reyb
绕圈	rcjr
绥靖	svjk
夙愿	suyr
诉状	suvl
素爱	suai
送往	sswh
送入	ssru
松茸	ssrs
酸爽	srul
蒜瓣	srbj
缩窄	sovd
散席	sjxi
散散	sjsj
散客	sjke
散光	sjgl
三餐	sjcj
三层	sjcg
私情	siqk
私密	simi
撕烂	silj
死叉	siia
丝滑	sihx
厮打	sida
桑葚	shuf
色心	sexb
色衰	secv
腮红	sdhs
扫清	scqk
骚气	scqi
骚包	scbc
土司	tusi
图强	tujl
通配	tspw
同款	tskr
铜矿	tskl
童工	tsgs
贴纸	tpvi
铁青	tpqk
铁皮	tppi
铁管	tpgr
拖走	tozz
拖影	toyk
妥妥	toto
跳伞	tnsj
填列	tmlp
天劫	tmjp
挺严	tkyj
挺闲	tkxm
挺准	tkvy
挺少	tkuc
挺俗	tksu
挺松	tkss
挺色	tkse
挺骚	tksc
挺全	tkqr
听清	tkqk
挺牛	tknq
挺烂	tklj
挺假	tkjx
挺长	tkih
挺差	tkci
挺怪	tkgk
摊销	tjxn
叹词	tjci
体腔	tiql
踢开	tikd
梯度	tido
糖浆	thjl
太脏	tdzh
台柱	tdvu
太瘦	tduz
太轻	tdqk
太矮	tdai
拓印	tayb
踏青	taqk
收窄	uzvd
售楼	uzlz
收罗	uzlo
手粗	uzcu
手残	uzcj
顺子	uyzi
顺滑	uyhx
耍猴	uxhz
水中	uvvs
暑热	uure
熟客	uuke
鼠胆	uudj
涮涮	urur
说点	uodm
双色	ulse
双栖	ulqi
双开	ulkd
双份	ulff
山乡	ujxl
善款	ujkr
施压	uiya
嗜血	uixp
试着	uivc
试水	uiuv
实数	uiuu
屎尿	uinn
师门	uimf
剩女	ugnv
省了	ugle
甚于	ufyu
神龙	ufls
伸长	ufih
社群	ueqy
蛇皮	uepi
折弯	uewj
住下	vuxx
主推	vutv
筑牢	vulc
忠孝	vsxn
中号	vshc
中饭	vsfj
中俄	vsee
颛顼	vrxu
着笔	vcbi
站桩	vjvl
战功	vjgs
战队	vjdv
直营	viyk
致死	visi
智库	viku
直降	vijl
制动	vids
掌纹	vhwf
征信	vgxb
整晚	vgwj
蒸煮	vgvu
正忙	vgmh
整列	vglp
整行	vghh
正方	vgfh
真脏	vfzh
真难	vfnj
真丑	vfiz
针管	vfgr
这项	vexl
褶皱	vevz
这届	vejp
找虐	vcnt
找遍	vcbm
炸窝	vawo
咋不	vabu
威压	wwya
微创	wwil
微薄	wwbc
五年	wunm
卧槽	wocc
窝边	wobm
挽住	wjvu
挽着	wjvc
玩票	wjpn
网文	whwf
外框	wdkl
巡夜	xyye
讯息	xyxi
殉情	xyqk
下锅	xxgo
熊熊	xsxs
胸闷	xsmf
炫酷	xrku
选重	xris
选股	xrgu
写满	xpmj
相思	xlsd
相若	xlro
响铃	xllk
想成	xlig
香瓜	xlgx
香醋	xlcu
刑讯	xkxy
醒脑	xknc
刑拘	xkgz
嘻哈	xiha
西段	xidr
优选	yzxr
优渥	yzwo
由头	yztz
友邻	yzlb
预产	yuij
越小	ytxn
越大	ytda
用回	yshv
远看	yrkj
圆角	yrjn
圆管	yrgr
远比	yrbi
鹰爪	ykvc
盈缺	ykqt
依循	yixy
业障	yevh
要能	ycng
嘴上	zvuh
宗门	zsmf
纵队	zsdv
总店	zsdm
做些	zoso
暂列	zjlp
自修	zixq
早说	zcuo
皂角	zcjn
早会	zchv
早该	zcgd
爱咋咋地	avvd
暗自庆幸	azqx
安享晚年	axwn
安身之所	auvs
凹凸有致	atyv
安然自若	arzr
安然无事	armu
安然入睡	arru
安然入眠	arrm
爱慕虚荣	amxr
挨门逐户	amvh
阿其所好	eqsh
不醉不归	bzbg
不言自明	byzm
别有一番	byyf
鲍鱼之肆	byvs
必有近忧	byjy
不用担心	bydx
宝相庄严	bxvy
笔下生花	bxuh
不懈努力	bxnl
本小利大	bxld
不宣而战	bxev
本相毕露	bxbl
别无他途	bwtt
不忘初心	bwix
不无道理	bwdl
不知死活	bvsh
不斩来使	bvlu
不支持了	bvil
不知高低	bvgd
不知凡几	bvfj
背山面水	bumu
不施粉黛	bufd
不守妇道	bufd
不识大体	budt
百试百灵	bubl
不太赞成	btzi
不太喜欢	btxh
不太习惯	btxg
别太晚了	btwl
不太熟悉	btux
不太适合	btug
不太舒服	btuf
不太认识	btru
不太认同	btrt
不通人情	btrq
不通情理	btql
不太满意	btmy
抱头乱串	btui
不太看好	btkh
不太好看	bthk
不太好吧	bthb
不太高兴	btgx
别太过分	btgf
不太方便	btfb
不太安全	btaq
霸权主义	bqvy
不平则鸣	bpzm
不怕一万	bpym
不明事理	bmul
闭目塞听	bmst
笔墨官司	bmgs
表里一致	blyv
白龙鱼服	blyf
玻璃纤维	blqw
波澜起伏	blqf
摆龙门阵	blmv
不堪造就	bkzj
不可懈怠	bkxd
不可外扬	bkwy
不可知论	bkvl
不可全信	bkqx
不可抗力	bkkl
不可不知	bkbv
八九月份	bjyf
不尽完美	bjwm
不近情理	bjql
不拘泥于	bgny
不讲面子	bjmz
不教而诛	bjev
暴虎冯河	bhfh
白鹤亮翅	beli
悲观主义	bgvy
百舸争流	bgvl
不甘后人	bghr
不管不问	bgbw
变法维新	bfwx
兵分两路	bfll
不复当年	bfdn
不二法则	befz
不得有误	bdyw
不得不服	bdbf
卑鄙无耻	bbmi
步步莲花	bblh
必不可缺	bbkq
包办代替	bbdt
斑斑点点	bbdd
不按常理	bail
寸有所长	cysi
雌雄异体	cxyt
雌雄同体	cxtt
此消彼长	cxbi
财政危机	cvwj
财政税收	cvuu
此生无憾	cumh
藏身之地	cuvd
才疏识浅	cuuq
残汤剩饭	ctuf
从头开始	ctku
寸土寸金	ctcj
沧桑坎坷	cskk
翠绕珠围	crvw
从轻处置	cqiv
层林尽染	cljr
猜来猜去	clcq
蹭吃蹭喝	cich
摧城拔寨	cibv
慈航普度	chpd
挫骨扬灰	cgyh
此地无银	cdmy
草草收尾	ccuw
层层叠叠	ccdd
才不至于	cbvy
草本植物	cbvw
寸步难移	cbny
伺机而动	cjed
大音希声	dyxu
第一桶金	dytj
大雨瓢泼	dypp
第一反应	dyfy
大象无形	dxmx
打小算盘	dxsp
大限将至	dxjv
大雪纷飞	dxff
对外贸易	dwmy
当我没说	dwmu
敌我矛盾	dwmd
对外开放	dwkf
跌无可跌	dmkd
大致说来	dvul
低声细语	duxy
打听打听	dtdt
抖擞精神	dsju
淡若清风	drqf
打入冷宫	drlg
刀枪入库	dqrk
冬去春来	dqil
东跑西颠	dpxd
打马虎眼	dmhy
砥砺前行	dlqh
打了鸡血	dljx
定了定神	dldu
得来不易	dlby
定睛一看	djyk
待机时间	djuj
堆金积玉	djjy
断简残编	djcb
滴酒不沾	djbv
东海扬尘	dhyi
达官显贵	dgxg
顶个屁用	dgpy
倒挂金钟	dgjv
倒挂金钩	dgjg
刀耕火种	dghi
顶风作案	dfza
大方无隅	dfmy
挡风遮雨	dfvy
大发善心	dfux
大富大贵	dfdg
等而下之	dexv
大而无当	demd
当耳旁风	depf
得而复失	defu
大打折扣	dduk
打打闹闹	ddnn
嘟嘟囔囔	ddnn
弟弟妹妹	ddmm
点灯熬油	dday
单兵作战	dbzv
都不一样	dbyy
大病一场	dbyi
都不喜欢	dbxh
道不拾遗	dbuy
大白若辱	dbrr
大病初愈	dbiy
断编残简	dbcj
叨陪末座	dpmz
追亡逐北	dwvb
恶语相向	eyxx
恩怨是非	eyuf
二三月份	esyf
耳软心活	erxh
二人世界	eruj
耳目众多	emvd
二话不说	ehbu
二道贩子	edfz
二不跨五	ebkw
二八法则	ebfz
二八定律	ebdl
十一二月	eyey
十指连弹	evld
飞扬小鹤	fyxe
敷衍塞责	fysz
佛要金装	fyjv
风雨不透	fybt
焚香沐浴	fxmy
费心费力	fxfl
芳心暗许	fxax
附赘悬疣	fvxy
负债累累	fvll
富强发达	fjfd
反面人物	fmrw
负面情绪	fmqx
反面教材	fmjc
放马后炮	fmhb
放马过来	fmgl
服了你了	flnl
放浪不羁	flbj
佛口蛇心	fkux
富甲一方	fjyf
抚今思昔	fjsx
分久必合	fjbg
非常重要	fiiy
风吹日晒	firu
繁华落尽	fhlj
富贵花开	fghk
风高放火	fgfh
方方正正	ffvv
泛泛之辈	ffvb
发发牢骚	ffls
飞蛾投火	feth
风大雨大	fdyd
风刀霜剑	fduj
妇道人家	fdrj
防毒面具	fdmj
福大命大	fdmd
故作姿态	gzzt
个子高高	gzgg
歌以咏志	gyyv
古已有之	gyyv
感性认识	gxru
隔靴挠痒	gxny
规章制度	gvvd
根正苗红	gvmh
归真返璞	gvfp
高枕而卧	gvew
盖世太保	gutb
故事梗概	gugg
国事访问	gufw
共同市场	gtui
公私分明	gsfm
工人阶级	grjj
攻其无备	gjmb
苟且偷安	gjta
顾盼自雄	gpzx
割袍断义	gpdy
敢怒敢言	gngy
广袤无垠	gmmy
概莫能外	gmnw
格林威治	glwv
古里古怪	glgg
搞了半天	glbt
鬼哭神嚎	gkuh
国际主义	gjvy
过江之鲫	gjvj
管见所及	gjsj
感觉良好	gjlh
骨骼清奇	ggqj
孤寡老人	gglr
改革创新	ggix
公共场所	ggis
搞风搞雨	gfgy
高尔夫球	gefq
扛鼎之作	gdvz
古典主义	gdvy
高等教育	gdjy
搞东搞西	gdgx
更不用说	gbyu
鬼不像鬼	gbxg
更不可能	gbkn
高矮胖瘦	gapu
合成纤维	giqw
合乎逻辑	ghlj
句句在理	ggzl
莞尔一笑	geyx
花园洋房	hyyf
荒淫无度	hymd
好一阵子	hyvz
后院起火	hyqh
获益良多	hyld
鸿雁传书	hyiu
行有行规	hyhg
诲淫诲盗	hyhd
花样百出	hybi
欢欣雀跃	hxqy
毫无怨言	hmyy
毫无预兆	hmyv
毫无征兆	hmvv
换位思考	hwsk
毫无办法	hmbf
蕙质兰心	hvlx
厚着脸皮	hvlp
还手之力	huvl
昏睡百年	hubn
回头再说	htzu
回天无力	html
昏头转向	htvx
回头看看	htkk
撼天动地	htdd
互诉衷肠	hsvi
花入各眼	hrgy
和气生财	hquc
魂牵梦系	hqmj
或轻或重	hqhi
胡拼乱凑	hplc
黄埔军校	hbjj
狐朋狗党	hpgd
浩渺无垠	hmmy
慌里慌张	hlhv
虎口脱险	hktx
混口饭吃	hkfi
花开富贵	hkfg
阖家幸福	hjxf
好几十年	hjen
阖家欢乐	hjhl
阖家安康	hjak
横冲直闯	hivi
汗出如浆	hirj
混吃等死	hids
好好说话	hhuh
挥毫洒墨	hhsm
和和气气	hhqq
好合好散	hghs
和光同尘	hgti
红光满面	hgmm
厚古薄今	hgbj
毫发无伤	hfmu
毫发无损	hfms
花儿朵朵	hedd
化敌为友	hdwy
荒诞无稽	hdmj
何德何能	hdhn
互不影响	hbyx
花边新闻	hbxw
毫不逊色	hbxs
后半辈子	hbbz
后半部分	hbbf
行不更名	hbgm
赤子之心	izvx
穿凿附会	izfh
尺有所短	iysd
穿云破雾	iypw
产业革命	iygm
吃哑巴亏	iybk
创新能力	ixnl
吃相难看	ixnk
重新开始	ixku
长效机制	ixjv
吃现成饭	ixif
成为一个	iwyg
晨钟暮鼓	ivmg
出师未捷	iuwj
初始状态	iuvt
抽水马桶	iumt
诚实可靠	iukk
抽身而去	iueq
出头露面	itlm
出人意外	iryw
出人意表	iryb
成仁取义	irqy
春秋鼎盛	iqdi
常年在外	inzw
出谋献策	imxc
臣门如市	imru
愁眉泪眼	imly
程门立雪	imlx
出毛病了	imbl
豺狼虎豹	ilhb
查漏补缺	ilbq
除旧布新	ijbx
车轱辘话	iglh
乘风扬帆	ifyf
春风拂面	iffm
闯荡江湖	idjh
吃不下饭	ibxf
沉不住气	ibvq
常备不懈	ibbx
抢先一步	ixyb
抢购一空	igyk
重心不稳	ixbw
种类繁多	ilfd
教子有方	jzyf
教子无方	jzmf
君子慎独	jzud
尖嘴薄舌	jzbu
建言献策	jyxc
节约时间	jyuj
技压群雄	jyqx
疾言厉色	jyls
锦绣年华	jxnh
匠心独运	jxdy
绝无二心	jmex
价值千金	jvqj
君主立宪	jvlx
监守自盗	juzd
九十月份	jeyf
尽释前嫌	juqx
精神可嘉	jukj
精神百倍	jubb
交通工具	jtgj
紧随其后	jsjh
救人一命	jrym
近日无仇	jrmi
既然这样	jrvy
节日快乐	jrkl
敬请期待	jqjd
金盆洗手	jpxu
就怕万一	jpmy
今年以来	jnyl
今明两年	jmln
简明扼要	jmey
戒律清规	jlqg
积劳成疾	jlij
精力过剩	jlgu
艰苦朴素	jkps
交口称赞	jkiz
缄口不言	jkby
经济危机	jjwj
结结实实	jjuu
经济实惠	jjuh
竞技体育	jjty
积极进取	jjjq
积毁销骨	jhxg
几何图形	jhtx
江湖骗子	jhpz
简化汉字	jhhz
巾帼英雄	jgyx
技高一筹	jgyi
军国主义	jgvy
金光闪闪	jguu
举国同庆	jgtq
结果如何	jgrh
几个来回	jglh
几个回合	jghg
几个方面	jgfm
疾风迅雷	jfxl
绝非善类	jful
绝非偶然	jfor
街坊邻居	jflj
见缝就钻	jfjz
结发夫妻	jffq
奖罚分明	jffm
饥餐渴饮	jcky
简便易行	jbyh
戒备森严	jbsy
即便如此	jbrc
揭不开锅	jbkg
绝不放手	jbfu
记不得了	jbdl
奇技淫巧	jjyq
奇花异木	jhym
降龙伏虎	jlfh
枯鱼之肆	kyvs
可以攻玉	kygy
开枝散叶	kvsx
控制面板	kvmb
开山祖师	kuzu
犒赏三军	kusj
开山鼻祖	kubz
磕头碰脑	ktpn
看清楚了	kqil
枯木死灰	kmsh
看了一下	klyx
苦辣酸甜	klst
可了不得	klbd
看看再说	kkzu
开阔视野	kkuy
坎坷不平	kkbp
开口闭口	kkbk
堪称一绝	kiyj
开诚相见	kixj
可乘之隙	kivx
空谷足音	kgzy
旷古未闻	kgww
看风使舵	kfud
狂风恶浪	kfel
口不择言	kbvy
可不是吗	kbum
恐怖分子	kbfz
立足未稳	lzww
来踪去迹	lzqj
另有所指	lysv
另有企图	lyqt
另眼看待	lykd
利用价值	lyjv
烈焰红唇	lyhi
六月飞雪	lyfx
理性认识	lxru
劳心劳力	lxll
冷血动物	lxdw
略显不足	lxbz
临阵退缩	lvts
来者可追	lvkd
老神在在	luzz
流水作业	luzy
来势汹汹	luxx
老少皆知	lujv
绿水长流	luil
六神不安	luba
雷霆雨露	ltyl
犁庭扫穴	ltsx
楼堂馆所	ltgs
聊天打屁	ltdp
理所应当	lsyd
绿色植物	lsvw
拉三扯四	lsis
绿色环保	lshb
两三个月	lsgy
令人咋舌	lrvu
令人意外	lryw
令人遐想	lrxx
令人向往	lrxw
令人心痛	lrxt
令人瞩目	lrvm
令人深思	lrus
令人痛心	lrtx
令人头疼	lrtt
礼让三分	lrsf
令人喷饭	lrpf
令人难忘	lrnw
令人难堪	lrnk
令人难过	lrng
令人惊叹	lrjt
令人敬佩	lrjp
令人叫绝	lrjj
令人激动	lrjd
令人骄傲	lrja
令人怀疑	lrhn
令人回味	lrhw
令人害怕	lrhp
令人高兴	lrgx
令人鼓舞	lrgw
令人感慨	lrgk
令人尴尬	lrgg
令人愤慨	lrfk
令人扼腕	lrew
令人担忧	lrdy
令人担心	lrdx
烈日当空	lrdk
老弱残兵	lrcb
令人不满	lrbm
令人不快	lrbk
令人不齿	lrbi
令人不安	lrba
令人安慰	lraw
六七月份	lqyf
两栖动物	lqdw
老牛破车	lnpi
临难不惧	lnbj
冷眉冷眼	lmly
搂搂抱抱	llbb
冷酷无情	lkmq
利己主义	ljvy
临界状态	ljvt
恋奸情热	ljqr
拉家带口	ljdk
路经此地	ljcd
凌迟处死	liis
来处不易	liby
离愁别恨	libh
利害相关	lhxg
略高一筹	lgyi
两国交兵	lgjb
龙肝凤髓	lgfs
老而不死	lebs
老掉牙了	ldyl
懒得理你	ldln
累得半死	ldbs
量才录用	lcly
了此残生	lccu
两把刷子	lbuz
屡败屡战	lblv
拉帮结伙	lbjh
两鬓斑白	lbbb
麻衣神相	myux
名誉扫地	mysd
妙语如珠	myrv
鸣冤叫屈	myjq
眯一会儿	myhe
命运多舛	mydi
面有菜色	mycs
密西西比	mxxb
没问题了	mwtl
忙这忙那	mvmn
面上无光	mumg
眉头一皱	mtyv
迷途羔羊	mtgy
木头疙瘩	mtgd
埋三怨四	msys
盲人瞎马	mrxm
茫然不解	mrbj
满腔热血	mqrx
忙前忙后	mqmh
美女如云	mnry
毛毛躁躁	mmzz
灭门绝户	mmjh
默默耕耘	mmgy
默默奉献	mmfx
没老没少	mlmu
没脸没皮	mlmp
明令禁止	mljv
明来暗往	mlaw
明火执仗	mhvv
马放南山	mfnu
满腹牢骚	mfls
命赴黄泉	mfhq
命大福大	mdfd
木本植物	mbvw
无遮无拦	mvml
万丈深渊	mvuy
万众期待	mvjd
无章可循	mvkx
万兽之王	muvw
万事亨通	muht
无土栽培	mtzp
无头苍蝇	mtcy
万死一生	msyu
无所忌惮	msjd
无人驾驶	mrju
万全之计	mqvj
无路可退	mlkt
无可取代	mkqd
无可讳言	mkhy
无可非议	mkfy
无迹可寻	mjkx
无处安身	miau
无话不说	mhbu
万法归宗	mfgz
无从知晓	mcvx
无补于事	mbyu
宁有种乎	nyih
逆向思维	nxsw
年深日久	nurj
逆天改命	ntgm
能掐会算	nqhs
南拳北腿	nqbt
宁缺不滥	nqbl
腻腻歪歪	nnww
黏黏糊糊	nnhh
农贸市场	nmui
浓眉大眼	nmdy
能力所及	nlsj
霓裳羽衣	niyy
怒火万丈	nhmv
年过三十	ngse
农副产品	nfip
脑袋瓜子	ndgz
难辨真伪	nbvw
辗转难眠	nvnm
疑难重症	nniv
偶一为之	oywv
萍踪浪迹	pzlj
拼音字母	pyzm
拼音文字	pywz
咆哮如雷	pxrl
旁系亲属	pjqu
平心静气	pxjq
片瓦无存	pwmc
片纸只字	pvvz
破竹之势	pvvu
旁枝末节	pvmj
屁事没有	pumy
平头正脸	ptvl
评头品足	ptpz
偏听偏信	ptpx
扑通扑通	ptpt
平平仄仄	ppzz
碰碰运气	ppyq
平平稳稳	ppww
平平整整	ppvv
批评指正	ppvv
朴朴实实	ppuu
仆仆风尘	ppfi
跑哪去了	pnql
破门而出	pmei
匹马单枪	pmdq
盆满钵满	pmbm
蒲柳之姿	plvz
普罗大众	pldv
怕苦怕累	pkpl
平均主义	pjvy
片甲不存	pjbc
骗吃骗喝	piph
派出机构	pijg
匹夫有责	pfyz
抛到脑后	pdnh
皮糙肉厚	pcrh
蓬勃发展	pbfv
扑鼻而来	pbel
平板电脑	pbdn
蜷作一团	qzyt
青眼相加	qyxj
秋月春风	qyif
气息奄奄	qxyy
缺心眼儿	qxye
缺心少肺	qxuf
七歪八扭	qwbn
旗帜鲜明	qvxm
曲折蜿蜒	quwy
缺肢少腿	qvut
切实可行	qukh
亲身经历	qujl
七十二行	qeeh
青山不改	qubg
轻松写意	qsxy
亲如手足	qruz
亲如骨肉	qrgr
千秋万载	qqmz
千秋万岁	qqms
亲亲热热	qqrr
七窍流血	qqlx
谦谦君子	qqjz
群情鼎沸	qqdf
七平八稳	qpbw
千难万阻	qnmz
轻拿轻放	qnqf
阡陌纵横	qmzh
千里同风	qltf
曲里拐弯	qlgw
千里鹅毛	qlem
七零八碎	qlbs
顷刻之间	qkvj
千金一掷	qjyv
千军易得	qjyd
齐集于此	qjyc
勤俭持家	qjij
穷家富路	qjfl
七尺男儿	qine
气冲牛斗	qind
秦皇汉武	qhhw
穷根究底	qgjd
秋风萧瑟	qfxs
气愤填膺	qfty
凄风冷雨	qfly
秋风过耳	qfge
气定神闲	qdux
青灯黄卷	qdhj
青灯古佛	qdgf
气度不凡	qdbf
七八月份	qbyf
拳不离手	qblu
千杯不醉	qbbz
前半部分	qbbf
人要衣装	ryyv
日益突出	ryti
人心险恶	rxxe
人心涣散	rxhs
人无远虑	rmyl
人文关怀	rwgh
人身自由	ruzy
日升月恒	ruyh
人寿年丰	runf
人生苦短	rukd
肉食动物	rsdw
人体工程	rtgi
忍辱求全	rrqq
任人摆布	rrbb
人强马壮	rjmv
戎马生涯	rmuy
人模人样	rmry
如梦如幻	rmrh
人民群众	rmqv
人间烟火	rjyh
日进万金	rjmj
日进千金	rjqj
日久年深	rjnu
日常用语	riyy
如花似锦	rhsj
人淡如菊	rdrj
人大代表	rddb
人不像人	rbxr
日不暇给	rbxg
容不容易	rbry
让不让人	rbrr
人比花娇	rbhj
人不犯我	rbfw
三灾八难	szbn
岁月无情	symq
岁月如梭	syrs
岁月荏苒	syrr
岁月蹉跎	syct
虽远必诛	sybv
森严壁垒	sybl
四下无人	sxmr
思乡情切	sxqq
三心两意	sxly
思想境界	sxjj
四五月份	swyf
思维模式	swmu
酸文假醋	swjc
四五个月	swgy
四肢发达	svfd
扫榻以待	styd
缩头乌龟	stwg
酸甜可口	stkk
三堂会审	sthu
三四月份	ssyf
斯斯文文	ssww
所思所想	sssx
三四个月	ssgy
随俗浮沉	ssfi
俗气得很	sqdh
随你的便	sndb
三年不鸣	snbm
四面开花	smkh
森罗万象	slmx
四季分明	sjfm
四处奔走	sibz
三好学生	shxu
岁寒三友	shsy
丧魂落魄	shlp
死灰槁木	shgm
三分天下	sftx
四方八面	sfbm
酸儿辣女	seln
随便你了	sbnl
酸不拉几	sblj
思不出位	sbiw
食物中毒	swvd
食不知味	sbvw
天姿国色	tzgs
徒增烦恼	tzfn
退一万步	tymb
统一战线	tyvx
田园牧歌	tymg
同业公会	tygh
袒胸露背	txlb
天文数字	twuz
天王老子	twlz
退无可退	tmkt
统治阶级	tvjj
太上老君	tulj
天时地利	tudl
滔天罪行	ttzh
天塌下来	ttxl
推推搡搡	ttss
头头脑脑	ttnn
滔天怒火	ttnh
滔滔江水	ttju
天塌地陷	ttdx
田头地里	ttdl
贪图安逸	ttay
吐丝自缚	tszf
讨人喜欢	trxh
坦然面对	trmd
台前幕后	tqmh
头皮发麻	tpfm
鸵鸟政策	tdvc
天南海北	tnhb
吐露心声	tlxu
拖了后腿	tlht
涕泪横流	tlhl
退居二线	tjex
田间地头	tjdt
坦诚相见	tixj
退出江湖	tijh
天差地别	tcdb
铁汉柔情	thrq
天高云淡	tgyd
铁骨铮铮	tgvv
唐古拉山	tglu
拖儿带女	tedn
天地玄黄	tdxh
天材地宝	tcdb
抬不起头	tbqt
透不过气	tbgq
手足相残	uzxc
实在是高	uzug
实用主义	uyvy
谁与争锋	uyvf
授业解惑	uyjh
少言寡语	uygy
上行下达	uhxd
收效甚微	uxuw
身心俱疲	uxjp
生无可恋	umkl
识文断字	uwdz
上知天文	uvtw
肾上腺素	uuxs
声声入耳	uure
神神秘秘	uubb
上吐下泻	utxx
上天入地	utrd
舍死忘生	uswu
水软山温	uruw
生日快乐	urkl
霜染白发	urbf
水平如镜	uprj
商品流通	uplt
审美疲劳	umpl
水漫金山	umju
睡眠不足	umbz
生理卫生	ulwu
水利枢纽	ulun
水利工程	ulgi
失节事大	ujud
身居高位	ujgw
手脚并用	ujby
数见不鲜	ujbx
抒怀言志	uhyv
社会制度	uhvd
说话算话	uhsh
售后服务	uhfw
说话带刺	uhdc
上纲上线	ugux
时光荏苒	ugrr
说个没完	ugmw
时乖命蹇	ugmj
伸个懒腰	ugly
说风凉话	uflh
是非黑白	ufhb
势单力薄	udlb
树大根深	udgu
说得过去	udgq
说不明白	ubmb
上兵伐谋	ubfm
上半辈子	ubbz
捉贼捉赃	vzvz
转一圈儿	vyje
状元及第	vyjd
桌椅板凳	vybd
知行合一	vhgy
植物纤维	vwqw
真伪难辨	vwnb
治外法权	vwfq
皱着眉头	vvmt
谆谆教导	vvjd
皱皱巴巴	vvbb
直上云霄	vuyx
真实写照	vuxv
志士仁人	vurr
知识产权	vuiq
逐水而居	vuej
指条明路	vtml
真他妈的	vtmd
震天动地	vtdd
至死不变	vsbb
知人之明	vrvm
终日奔波	vrbb
真情实意	vquy
中秋快乐	vqkl
知情不举	vqbj
捉拿归案	vnga
正面人物	vmrw
专门利人	vmlr
这么简单	vmjd
直眉瞪眼	vmdy
真可谓是	vkwu
斩将搴旗	vjqq
知己难求	vjnq
忠君爱国	vjag
转嗔为喜	viwx
丈二金刚	vejg
赚点外快	vdwk
真刀真枪	vdvq
真的假的	vdjd
捉刀代笔	vddb
招财进宝	vcjb
站不住脚	vbvj
直布罗陀	vblt
睁不开眼	vbky
真不愧是	vbku
择人而噬	vreu
咋不早说	vbzu
妄自揣测	wzic
五洋捉鳖	wyvb
物有所值	wysv
汪洋大海	wydh
温馨甜蜜	wxtm
畏畏缩缩	wwss
文文静静	wwjj
玩着玩着	wvwv
物质文明	wvwm
误中副车	wvfi
为山九仞	wujr
文山会海	wuhh
勿谈国事	wtgu
我所欲也	wsyy
王孙公子	wsgz
往日无怨	wrmy
为人正直	wrvv
温润如玉	wrry
温柔敦厚	wrdh
剜肉补疮	wrbi
巍然不动	wrbd
雾气腾腾	wqtt
乌漆墨黑	wqmh
威迫利诱	wply
问牛答马	wndm
五六月份	wlyf
五六个月	wlgy
武林高手	wlgu
温良恭俭	wlgj
危机重重	wjii
外交关系	wjgj
五角大楼	wjdl
外交辞令	wjcl
物超所值	wisv
外弛内张	winv
我还以为	whyw
维和部队	whbd
亡国之音	wgvy
闻风而起	wfeq
五短身材	wduc
五彩纷呈	wcfi
仙姿玉貌	xzym
稀有元素	xyys
献言献策	xyxc
鲜衣怒马	xynm
稀有金属	xyju
虚应故事	xygu
硝烟滚滚	xygg
兄友弟恭	xydg
学艺不精	xybj
心胸狭隘	xxxa
相形失色	xxus
形象思维	xxsw
小小年纪	xxnj
想想办法	xxbf
心外无物	xwmw
心中有鬼	xvyg
修正主义	xvvy
下知地理	xvdl
新生事物	xuuw
小试牛刀	xund
信守承诺	xuin
心事重重	xuii
相谈甚欢	xtuh
乡土气息	xtqx
心素如简	xsrj
血肉之躯	xrvq
小人之见	xrvj
笑容满面	xrmm
血肉模糊	xrmh
虚弱不堪	xrbk
徇情枉法	xqwf
香气扑鼻	xqpb
修桥补路	xqbl
香飘十里	xpel
雪里送炭	xlst
向来如此	xlrc
心灵鸡汤	xljt
绚丽多姿	xldz
休克疗法	xklf
心肌梗塞	xjgs
相差无几	xcmj
心潮起伏	xiqf
新婚快乐	xhkl
血光之灾	xgvz
先公后私	xghs
心肝宝贝	xgbb
秀而不实	xebu
心地善良	xdul
相对湿度	xdud
喜得贵子	xdgz
心存善念	xcun
心存敬畏	xcjw
想不明白	xbmb
小本经营	xbjy
下笔成章	xbiv
下半辈子	xbbz
越走越远	yzyy
有嘴无心	yzmx
有孕在身	yyzu
有缘无分	yymf
悠悠岁月	yysy
阴雨绵绵	yymm
烟雨蒙蒙	yymm
鱼跃龙门	yylm
阴雨连绵	yylm
庸庸碌碌	yyll
狺狺狂吠	yykf
一一过问	yygw
营养不良	yybl
一言不合	yybg
游戏人间	yxrj
野性难驯	yxnx
英雄豪杰	yxhj
忧喜参半	yxcb
一误再误	ywzw
余味无穷	ywmq
与我无关	ywmg
一无所能	ymsn
义务教育	ywjy
以壮行色	yvhs
言志抒怀	yvuh
有章可循	yvkx
宇宙洪荒	yvhh
一展风采	yvfc
义正辞严	yvcy
一时无两	yuml
养生之道	yuvd
以示清白	yuqb
有失偏颇	yupp
一声令下	yulx
一尸两命	yulm
一身冷汗	yulh
一手交钱	yujq
一手交货	yujh
依山傍水	yubu
一团漆黑	ytqh
一天两天	ytlt
一探究竟	ytjj
仰天长啸	ytix
仰天大笑	ytdx
一通百通	ytbt
意思一下	ysyx
一死了之	yslv
有所不知	ysbv
一死百了	ysbl
嫣然一笑	yryx
与人无争	yrmv
有如神助	yruv
引人深思	yrus
与日俱增	yrjz
有求于你	yqyn
有气没力	yqml
欲求不满	yqbm
有凭有据	ypyj
一片汪洋	ypwy
一片生机	ypuj
一片坦途	yptt
一票难求	ypnq
有屁快放	ypkf
一片焦土	ypjt
有屁就放	ypjf
一屁股债	ypgv
一片光明	ypgm
以你为荣	ynwr
英明一世	ymyu
一脉相通	ymxt
一面之缘	ymvy
仰慕之情	ymvq
榆木脑袋	ymnd
一抹亮色	ymls
夜幕降临	ymjl
有来有往	ylyw
有零有整	ylyv
一冷一热	ylyr
越来越难	ylyn
娱乐娱乐	ylyl
又累又困	ylyk
越来越差	ylyc
又冷又饿	ylye
雨露均沾	yljv
一两个月	ylgy
一鳞半爪	ylbv
云开日出	ykri
一刻千金	ykqj
有口难分	yknf
有口难辩	yknb
又惊又喜	yjyx
英俊潇洒	yjxs
有教无类	yjml
永结同心	yjtx
一己私利	yjsl
一将难求	yjnq
言出法随	yifs
一触而发	yief
月黑杀人	yhur
一会就好	yhjh
羽化成仙	yhix
一哄而起	yheq
油光锃亮	ygzl
因果循环	ygxh
阳刚之气	ygvq
掩过饰非	yguf
一个来回	yglh
一个礼拜	yglb
阳光灿烂	ygcl
有负所托	yfst
一番口舌	yfku
一二月份	yeyf
移动硬盘	ydyp
一代天骄	ydtj
元旦快乐	ydkl
言辞凿凿	yczz
一败再败	ybzb
以暴制暴	ybvb
一把年纪	ybnj
有备而来	ybel
因爱生恨	yauh
仄仄平平	zzpp
早有预谋	zyym
自由竞争	zyjv
尊严尽丧	zyjs
自由放任	zyfr
作用不大	zybd
自寻短见	zxdj
左问右问	zwyw
自我牺牲	zwxu
自我表现	zwbx
资深望重	zuwi
再衰三竭	zcsj
在天有灵	ztyl
自然灾害	zrzh
自然规律	zrgl
在情在理	zqzl
早去早回	zqzh
走马看花	zmkh
走漏风声	zlfu
再苦再累	zkzl
坐困愁城	zkii
早就有了	zjyl
早就醒了	zjxl
早就没了	zjml
纵酒欢歌	zjhg
祖传配方	zipf
脏活累活	zhlh
锃光瓦亮	zgwl
自动调频	zddp
最大努力	zdnl
最大可能	zdkn
杂草丛生	zccu
做不了主	zblv
坐不改姓	zbgx
走不动了	zbdl
按下葫芦起来瓢	axhp
按常理来说	ailu
百足之虫，死而不僵	bzvj
不在其位，不谋其政	bzqv
别有一番风味	byyw
八仙过海，各显神通	bxgt
八仙过海，各显其能	bxgn
不幸而言中	bxe
不是鱼死，就是网破	buyp
不是吃素的	buid
半桶水，响叮当	btud
不听老人言	btly
不听老人言，吃亏在眼前	btlq
比死人多口气	bsrq
不如意事常八九	bryj
不如授人以渔	bruy
被人卖了还帮着数钱	brmq
不求闻达于诸侯	bqwh
病去如抽丝	bqrs
不怕一万，就怕万一	bpyy
半瓶水响叮当	bpud
不怕没柴烧	bpmu
不怕不识货	bpbh
兵马未动，粮草先行	bmwh
别来这一套	blvt
不虑胜先虑败	blub
不见真佛不烧香	bjvx
不吃羊肉惹身臊	biys
冰火两重天	bhlt
不够塞牙缝	bgsf
拔根汗毛比腰粗	bghc
不放在眼里	bfzl
不得不低头	bdbt
病从口入，祸从口出	bcki
不把自己当外人	bbzr
不按常理出牌	baip
藏之名山，传之其人	cvmr
此时无声胜有声	cumu
此风不可长	cfbi
从刀尖上爬过来的	cdjd
弟子服其劳	dzfl
东一榔头西一棒子	dylz
东向而望，不见西墙	dxeq
大战三百回合	dvsg
打着灯笼找不着	dvdv
大事化小，小事化了	duhl
对事不对人	dubr
爹死娘嫁人，各人顾各人	dsnr
单丝不成线	dsbx
端人家碗，受人家管	drjg
大人不记小人过	drbg
得便宜卖乖	dbyg
大难不死，必有后福	dnbf
当面是人，背后是鬼	dmug
当面鼓对面锣	dmgl
大路朝天，各走一边	dlib
渡尽劫波兄弟在	djjz
打狗还得看主人	dghr
豆腐渣工程	dfvi
躲得了初一躲不过十五	ddlw
貂不足，狗尾续	dbzx
大白于天下	dbyx
打不着狐狸惹身骚	dbvs
大白天说梦话	dbth
二者必居其一	evby
二者不可得兼	evbj
耳听为虚，眼见为实	etwu
饿死胆小的	esdd
儿女情长，英雄气短	enqd
儿大不由娘	edbn
儿不嫌母丑，狗不嫌家贫	ebxp
十里不同俗	elbs
腹有诗书气自华	fyuh
蜉蝣撼大树	fyhu
反误了卿卿性命	fwlm
凡人不可貌相	frbx
飞鸟尽良弓藏	fdjc
防民之口，甚于防川	fmvi
风里来，雨里去	fllq
翻脸不认人	flbr
防君子不防小人	fjzr
风高放火天	fgft
狗嘴吐不出象牙	gzty
工欲善其事，必先利其器	gyuq
过一天算一天	gytt
苟全性命于乱世	gqxu
革命尚未成功，同志仍需努力	gmul
革命尚未成功	gmug
过了这个村就没这个店了	glvl
刚出狼窝，又入虎口	gilk
关公面前耍大刀	ggmd
苟富贵，勿相忘	gfgw
公道自在人心	gdzx
各打五十大板	gdwb
胳膊肘往外拐	gbvg
汉贼不两立	hzbl
好戏在后头	hxzt
黄鼠狼给鸡拜年	huln
皇天不负有心人	htbr
好死不如赖活	hsbh
害人之心不可有，防人之心不可无	hrvm
活人不能让尿憋死	hrbs
行家一出手，就知有没有	hjyy
好好学习，天天向上	hhxu
黄河之水天上来	hhvl
花花轿子人抬人	hhjr
黄花菜都凉了	hhcl
好汉不提当年勇	hhby
好话不说二遍	hhbb
好钢用在刀刃上	hgyu
皇帝轮流坐，明年到我家	hdlj
话不说不明	hbum
祸不及家人	hbjr
恨不得有条地缝钻进去	hbdq
行高于人，众必非之	hgyv
行不更名，坐不改姓	hbgx
行不得也哥哥	hbdg
成则为王，败则为寇	izwk
初一一回十五一回	iyyh
穿一条裤子	iytz
丑媳妇总得见公婆	ixfp
朝中有人好做官	ivyg
吃着碗里，望着锅里	ivwl
吃着碗里的，望着锅里的	ivwd
成事不足，败事有余	iuby
秤砣虽小压千斤	itsj
撑死胆大的	isdd
吃人家饭，受人家管	irjg
吃人家的嘴短	irjd
吃人不吐骨头	irbt
传男不传女	inbn
吹牛不打草稿	inbg
城门失火，殃及池鱼	imuy
窗户纸一点就破	ihvp
丑话说在前头	ihut
吹得天花乱坠	idtv
船到桥头自然直	idqv
春蚕到死丝方尽	icdj
盛名之下无虚士	imvu
长他人志气	itrq
长他人志气，灭自己威风	itrf
君子一言，驷马难追	jzyd
君子远庖厨	jzyi
君子之交淡如水	jzvu
君子动口不动手	jzdu
经一事，长一智	jyuv
将欲取之，必先予之	jyqv
酒香不怕巷子深	jxbu
近朱者赤，近墨者黑	jvvh
绝知此事要躬行	jvch
狡兔死走狗烹	jtsp
见人说人话	jruh
见人矮三分	jraf
就怕货比货	jphh
嫁鸡随鸡，嫁狗随狗	jjsg
急急如律令	jjrl
姜还是老的辣	jhul
酒后吐真言	jhty
饥寒起盗心	jhqx
计划没有变化快	jhmk
计划赶不上变化	jhgh
京杭大运河	jhdh
家花不如野花香	jhbx
计划不如变化快	jhbk
见鬼说鬼话	jguh
机关算尽太聪明	jgsm
巾帼不让须眉	jgbm
疾风扫落叶	jfsx
剪刀石头布	jddb
鸡蛋碰石头	jdpt
既当爹又当妈	jddm
旧的不去，新的不来	jdbl
酒不醉人人自醉	jbzz
久病无孝子	jbmz
强中自有强中手	jvzu
可与人言无二三	kyrs
开弓不放箭	kgbj
林子大了，什么鸟都有	lzdy
里约热内卢	lyrl
两眼泪汪汪	lylw
老乡见老乡	lxjx
来者不善，善者不来	lvbl
两头不是人	ltbr
两头不讨好	ltbh
临死拉个垫背的	lsld
狸猫换太子	lmhz
老来这一套	llvt
老将出马，一个顶俩	ljil
蜡炬成灰泪始干	ljig
谅解备忘录	ljbl
脸朝黄土背朝天	liht
老虎屁股摸不得	lhpd
两个黄鹂鸣翠柳	lghl
老而不死是为贼	lebz
两耳不闻窗外事	lebu
来得容易去得快	ldrk
劣币驱逐良币	lbqb
萝卜青菜，各有所爱	lbqa
满嘴跑火车	mzpi
灭自己威风	mzjf
木秀于林，风必摧之	mxyv
摸着石头过河	mvdh
明知不可为而为之	mvbv
谋事在人，成事在天	muzt
闷声发大财	mufc
麻雀虽小，五脏俱全	mqsq
马六甲海峡	mljx
没反应过来	mfyl
面不改色心不跳	mbgt
摸不到头绪	mbdx
门不当户不对	mbdd
万事不求人	mubr
无理搅三分	mljf
无利不起早	mlbz
宁做鸡头不做凤尾	nzjw
捏着一把汗	nvyh
拿人家的手软	nrjr
捏了一把汗	nlyh
拿了鸡毛当令箭	nljj
拿不定主意	nbdy
披着羊皮的狼	pvyl
皮之不存，毛将焉附	pvbf
泼出去的水	piqu
牵着鼻子走	qvbz
前人栽树，后人乘凉	qrzl
墙里开花墙外香	qlkx
曲里拐弯儿	qlge
千里不同风	qlbf
千金之子，坐不垂堂	qjvt
缺胳膊少腿	qgbt
棋逢对手，将遇良才	qfdc
人在屋檐下	rzwx
人在屋檐下，不得不低头	rzwt
日有所思，夜有所梦	rysm
仁义礼智信	rylx
人心齐泰山移	rxqy
人往高处走，水往低处流	rwgl
人为刀俎，我为鱼肉	rwdr
人之将死，其言也善	rvju
人是铁饭是钢	rutg
人生不如意事十之八九	rubj
人死如灯灭	rsrm
人人为我，我为人人	rrwr
人若犯我，我必犯人	rrfr
任凭风浪起	rpfq
热锅里的蚂蚁	rgly
人过留名，雁过留声	rglu
人多好干活	rdhh
人不为己，天诛地灭	rbwm
人不人鬼不鬼	rbrg
人不犯我，我不犯人	rbfr
三月不知肉味	sybw
塞翁失马，安知非福	swuf
三十年河西	senx
三十年河东	send
三天三夜说不完	stsw
酸甜苦辣咸	stkx
三岁小孩都知道	ssxd
损人不利己	srbj
僧来看佛面	slkm
三更灯火五更鸡	sgdj
三步一岗，五步一哨	sbyu
算不了什么	sblm
食君之禄，忠君之事	sjvu
天作孽犹可恕	tznu
太阳从西边出来	tycl
天王老子都不怕	twlp
同志仍需努力	tvrl
头上三尺有神明	tusm
天上不会掉馅饼	tubb
剃头挑子一头热	tttr
桃李不言，下自成蹊	tlbq
螳螂捕蝉，黄雀在后	tlbh
跳进黄河洗不清	tjhq
替古人担忧	tgry
天打五雷轰	tdwh
偷得浮生半日闲	tdfx
胜造七级浮屠	uzqt
是药三分毒	uysd
上知天文，下知地理	uvtl
是骡子是马，拉出来溜溜	ulzl
水里来火里去	ullq
师傅领进门，修行靠个人	uflr
师傅领进门	uflm
伤敌一千，自损八百	udyb
蜀道难，难于上青天	udnt
只许州官放火，不许百姓点灯	vxvd
站着说话不嫌腰疼	vvut
纸上得来终觉浅	vudq
真人不露相	vrbx
中看不中用	vkby
照方子抓药	vfzy
直布罗陀海峡	vblx
玩于股掌之上	wygu
望山跑死马	wupm
玩弄于鼓掌之中	wlyv
外来和尚好念经	wlhj
温良恭俭让	wlgr
挽狂澜于既倒	wkld
侠以武犯禁	xywj
先小人后君子	xxrz
小心没大错	xxmc
修行靠个人	xhkr
闲着也是闲着	xvyv
闲着没事干	xvmg
新账老账一起算	xvls
形势比人强	xubj
效犬马之劳	xqml
喜怒不形于色	xnbs
羡慕嫉妒恨	xmjh
相看两不厌	xkly
鲜花插在牛粪上	xhiu
响鼓不需重锤	xgbi
相当有一套	xdyt
想到哪说到哪	xdnn
秀才造反，三年不成	xczi
秀才遇到兵，有理说不清	xcyq
秀才遇到兵	xcyb
秀才不出门	xcbm
远在天边，近在眼前	yztq
一字长蛇阵	yziv
有一利必有一弊	yylb
有冤报冤，有仇报仇	yybi
一心只读圣贤书	yxvu
英雄难过美人关	yxng
硬着头皮上	yvtu
一朝权在手，便把令来行	yiqh
严师出高徒	yuit
一条路跑到黑	ytlh
一条道跑到黑	ytdh
一人吃饱，全家不饿	yrie
一日不见如隔三秋	yrbq
欲穷千里目，更上一层楼	yqql
一片冰心在玉壶	ypbh
有奶便是娘	ynbn
夜猫子进宅，无事不来	ymzl
有理说不清	yluq
一粒老鼠屎，坏了一锅粥	yllv
一粒老鼠屎	yllu
有理不在声高	ylbg
一块石头落了地	ykdd
一颗老鼠屎，坏了一锅粥	yklv
一颗老鼠屎	yklu
有借有还，再借不难	yjyn
一家人不说两家话	yjrh
月黑杀人夜	yhuy
眼观六路，耳听八方	yglf
一个唱红脸，一个唱白脸	ygil
有福同享，有难同当	yftd
一分价钱一分货	yfjh
一顿饭功夫	ydff
咽不下这口气	ybxq
以彼之道还治其人之身	ybvu
一把屎一把尿	ybun
衣不如新，人不如故	ybrg
犹抱琵琶半遮面	ybpm
一边凉快去	yblq
用不了多久	yblj
一步错，步步错	ybcc
一把鼻涕一把泪	ybbl
自作孽不可活	zznh
早知今日，何必当初	zvji
嘴尖舌头快	zjuk
自古圣贤多寂寞	zgum
