拚	pbfc
拚	pjfc
背弃	bwqi
悲凉	bwll
补休	buxq
补习	buxi
布袋	budd
波音	boy
搏击	boj
博彩	boc
表叔	bnuu
表单	bndj
贬义	bmyi
贬值	bmvi
便签	bmqm
半途	bjtu
半斤	bjjb
搬到	bjdc
半岛	bjdc
辟邪	bixp
本源	bfyr
拜堂	bdth
败露	bdlu
摆放	bdfh
豹子	bczi
褒义	bcyi
包抄	bcic
滨江	bbjl
芭蕉	bajn
财迷	cdmi
差钱	ciqm
渡劫	dujp
低效	dixn
地势	deui
底气	diqi
低端	didr
档期	dhji
代购	ddgz
倒叙	dcxu
打坐	dazo
大侠	daxx
打完	dawj
大师	daui
大屏	dabk
大佬	dalc
搭车	daie
大号	dahc
鸟用	dnys
提点	didm
二笔	erbi
抚慰	fuww
附着	fuvc
复牌	fupd
腹稿	fugc
翻盘	fjpj
粉底	ffdi
柜员	gvyr
皈依	gvyi
归集	gvji
姑息	guxi
骨架	gujx
共识	gsui
公婆	gspo
攻克	gske
公会	gshv
管材	grcd
果盘	gopj
甘醇	gjiy
搞鬼	gcgv
会晤	hvwu
晦涩	hvse
护眼	huyj
呼噜	hulu
护栏	hulj
互换	huhr
护垫	hudm
晃眼	hlyj
黄龙	hlls
撼动	hjds
喝点	hedm
浩劫	hcjp
好点	hcdm
巷子	hhzi
初夏	iuxx
初秋	iuqq
初略	iult
触动	iuds
船舶	irbo
蟾蜍	ijiu
尺子	iizi
长串	ihir
橙子	igzi
承销	igxn
城防	igfh
晨会	ifhv
撤单	iedj
超市	icui
抢戏	igxi
重伤	isuh
长出	ihiu
甲醛	jxqr
加餐	jxcj
家财	jxcd
舅舅	jqjq
接盘	jppj
解禁	jpjb
解惑	jpho
叫嚣	jnxn
娇气	jnqi
奸商	jmuh
简练	jmlm
见地	jmde
剪刀	jmdc
浆糊	jlhu
镜像	jkxl
精细	jkxi
净水	jkuv
记性	jixk
挤占	jivj
锦绣	jbxq
系数	jiuu
开眼	kdyj
开战	kdvj
开合	kdge
开刀	kddc
卤汁	luvi
陆路	lqlu
路虎	luhu
留宿	lqsu
罗锅	logo
亮点	lldm
两笔	llbi
例行	lihh
捞取	lcqu
老姐	lcjp
老花	lchx
老哥	lcge
淋雨	lbyu
遴选	lbxr
林地	lbde
密闭	mibi
盟友	mgyz
迈入	mdru
迈出	mdiu
买点	mddm
毛糙	mccc
码字	mazi
万年	monm
农庄	nsvl
暖胃	nrww
难堪	njkj
南段	nadr
难捱	nj
噗嗤	puii
颇费	pofw
偏好	pmhc
蟠桃	pjtc
批语	piyu
疲乏	pifa
牌照	pdvc
躯壳	quke
屈才	qucd
全责	qrze
全市	qrui
全套	qrtc
全程	qrig
全班	qrbj
切腹	qpfu
情谊	qkyi
情商	qkuh
清零	qklk
青椒	qkjn
情妇	qkfu
欺压	qiya
栖息	qixi
歧途	qitu
砌墙	qiql
旗舰	qijm
气话	qihx
企划	qihx
妻儿	qier
纤体	qmti
入市	ruui
松鼠	ssuu
松松	ssss
送礼	ssli
酸楚	sriu
私信	sixb
死期	siji
秃鹫	tujq
徒弟	tudi
通晓	tsxn
通缉	tsji
天性	tmxk
天梯	tmti
填单	tmdj
挺住	tkvu
谈着	tjvc
特质	tevi
收纳	uzna
受理	uzli
收货	uzho
刷单	uxdj
竖条	uutn
善举	ujju
视野	uiye
试管	uigr
拾掇	uido
上限	uhxm
声誉	ugyu
生涩	ugse
声控	ugks
升幅	ugfu
审验	ufyj
身亡	ufwh
深耕	ufgg
申根	ufgf
折寿	ueuz
皱褶	vzve
骤降	vzjl
住院	vuyr
中药	vsyc
中日	vsri
指责	vize
支援	viyr
枝丫	viya
指示	viui
之上	viuh
智力	vili
致敬	vijk
纸巾	vijb
纸杯	vibw
征程	vgig
真元	vfyr
真乱	vflr
哲理	veli
尾页	wwye
为期	wwji
诬陷	wuxm
污水	wuuv
忤逆	wuni
误触	wuiu
晚睡	wjuv
晚辈	wjbw
晚报	wjbc
网名	whmk
文殊	wfuu
外伤	wduh
外接	wdjp
下限	xxxm
下滑	xxhx
叙事	xuui
选单	xrdj
协警	xpjk
咸鱼	xmyu
显露	xmlu
县城	xmig
相通	xlts
性命	xkmk
西施	xiui
戏曲	xiqu
心智	xbvi
心说	xbuo
心寒	xbhj
油水	yzuv
寓意	yuyi
玉成	yuig
原委	yrww
冤枉	yrwh
原生	yrug
原话	yrhx
眼熟	yjuu
严苛	yjke
意淫	yiyb
意向	yixl
养颜	yhyj
要想	ycxl
要是	ycui
要不	ycbu
音质	ybvi
引渡	ybdu
足月	zuyt
总管	zsgr
左派	zopd
自主	zivu
自建	zijm
杂碎	zasv
哎呦喂	ayw
爱谁谁	auu
安全性	aqx
按常理	ail
按道理	adl
熬不住	abv
熬不过	abg
拗不过	nbg
不吱声	bzu
不早了	bzl
不用了	byl
不由得	byd
悲喜剧	bxj
别瞎扯	bxi
不行吧	bxb
不指望	bvw
不追求	bvq
不舒服	buf
辨识度	bud
别太晚	btw
不听劝	btq
并蹄莲	btl
不痛快	btk
不太敢	btg
白天鹅	bte
不然呢	brn
不便宜	bpy
白内障	bnv
别闹了	bnl
不满意	bmy
不理想	blx
不论是	blu
贝雷帽	blm
玻璃杯	blb
百家姓	bjx
笔记本	bjb
半成品	bip
不扯了	bil
不合适	bgu
帮个忙	bgm
不干胶	bgj
不服气	bfq
百分点	bfd
半吊子	bdz
帮倒忙	bdm
背地里	bdl
并不想	bbx
摆摆手	bbu
并不能	bbn
帮帮忙	bbm
把把脉	bbm
并不会	bbh
不安全	baq
参与度	cyd
才需要	cxy
聪明人	cmr
葱姜蒜	cjs
残次品	ccp
擦擦汗	cch
藏不住	cbv
都在玩	dzw
地藏王	dcw
打嘴仗	dzv
得益于	dyy
多一些	dys
单眼皮	dyp
等于零	dyl
单引号	dyh
掉下去	dxq
刀削面	dxm
党中央	dvy
董事长	dui
大使馆	dug
独特性	dtx
单人床	dri
大排档	dpd
东南风	dnf
多面手	dmu
大忙人	dmr
倒插门	dim
导火线	dhx
动画片	dhp
点点头	ddt
堵得慌	ddh
倒不是	dbu
代表团	dbt
对比度	dbd
提出来	dil
石墨烯	dmx
二选一	exy
二十年	een
二郎腿	elt
二合一	egy
十位数	ewu
复杂性	fzx
风向标	fxb
服务器	fwq
夫妻店	fqd
放弃吧	fqb
发脾气	fpq
服你了	fnl
发霉了	fml
发牢骚	fls
氟利昂	fla
福建省	fju
风景区	fjo
房产证	fiv
反编译	fby
更新了	gxl
关系户	gjh
国务卿	gwq
观世音	guy
过山车	gui
国土局	gtj
甘肃省	gsu
公平性	gpx
国内外	gnw
姑奶奶	gnn
根目录	gml
规模化	gmh
鼓浪屿	gly
公开信	gkx
公开赛	gks
关节炎	gjy
公积金	gjj
根据地	gjd
过程中	giv
观察力	gil
古惑仔	ghz
搞混了	ghl
共和党	ghd
搞搞震	ggv
更别说	gbu
搞半天	gbt
更不能	gbn
赶不及	gbj
合理性	glx
洪泽湖	hzh
活脱脱	htt
黑天鹅	hte
换气扇	hqu
海平面	hpm
湖南省	hnu
河南省	hnu
黄梅戏	hmx
灰蒙蒙	hmm
坏毛病	hmb
惠灵顿	hld
户口簿	hkb
户口本	hkb
好几年	hjn
好几回	hjh
好几次	hjc
候车室	hiu
好处费	hif
挥挥手	hhu
好好说	hhu
哈哈哈	hhh
还好吧	hhb
花果山	hgu
花骨朵	hgd
活到老	hdl
好多次	hdc
还不少	hbu
创造性	izx
程序员	ixy
颤巍巍	iww
出问题	iwt
常委会	iwh
称之为	ivw
处女作	inz
崇明岛	imd
长方形	ifx
吃得消	idx
吃得开	idk
臭豆腐	idf
长白山	ibu
唱白脸	ibl
重口味	ikw
局域网	jyw
假惺惺	jxx
江西省	jxu
基围虾	jwx
就为了	jwl
经纬度	jwd
集装箱	jvx
急转弯	jvw
交通局	jtj
急死了	jsl
捡起来	jql
吉普赛	jps
纪念日	jnr
吉林省	jlu
加勒比	jlb
接力棒	jlb
加减法	jjf
监护人	jhr
就好了	jhl
菊花茶	jhi
就好比	jhb
几个钱	jgq
举个例	jgl
加工厂	jgi
筋斗云	jdy
讲道理	jdl
记不清	jbq
绝不会	jbh
强有力	jyl
客运站	kyv
空心菜	kxc
跨时代	kud
看清楚	kqi
开门红	kmh
可见度	kjd
开发区	kfo
看电视	kdu
苦丁茶	kdi
看得懂	kdd
抗不住	kbv
看不上	kbu
利用率	lyl
聊一聊	lyl
练一练	lyl
留言簿	lyb
旅行社	lhu
留下来	lxl
冷笑话	lxh
遛弯儿	lwe
连轴转	lvv
两只手	lvu
愣头青	ltq
六七年	lqn
零配件	lpj
绿帽子	lmz
联络函	llh
理解力	ljl
兰花指	lhv
零花钱	lhq
厉害了	lhl
铝合金	lgj
厉害吧	lhb
两个半	lgb
理不清	lbq
冷不冷	lbl
离不开	lbk
零部件	lbj
冷不防	lbf
轮不到	lbd
弄不清	lbq
弄不懂	lbd
梦一场	myi
毛主席	mvx
民主党	mvd
没听清	mtq
忙死了	msl
美人儿	mre
买买买	mmm
母老虎	mlh
梅花鹿	mhl
眯会儿	mhe
墨尔本	meb
明白了	mbl
末班车	mbi
无人机	mrj
那一套	nyt
哪一天	nyt
哪一款	nyk
哪一回	nyh
哪一次	nyc
脑膜炎	nmy
那句话	ngh
哪几个	njg
能见度	njd
农产品	nip
尼古丁	ngd
尼姑庵	nga
脑袋瓜	ndg
区域化	oyh
偏向于	pxy
培训班	pxb
抛物线	pwx
偏重于	piy
攀枝花	pvh
葡萄酒	ptj
爬起来	pql
撇撇嘴	ppz
贫民窟	pmk
配不上	pbu
漂白粉	pbf
跑不掉	pbd
趋向于	qxy
趣味性	qwx
权威性	qwx
前阵子	qvz
企事业	quy
潜水艇	qut
全天候	qth
全球化	qqh
敲门砖	qmv
千里眼	qly
秋老虎	qlh
前几日	qjr
清洁剂	qjj
气冲冲	qii
气鼓鼓	qgg
千岛湖	qdh
七八年	qbn
去不了	qbl
起不来	qbl
人社局	ruj
热空气	rkq
肉嘟嘟	rdd
让不让	rbr
热不热	rbr
所有制	syv
思想家	sxj
四星级	sxj
三星级	sxj
三文鱼	swy
四五天	swt
三五天	swt
三五年	swn
四五年	swn
私生子	suz
私生女	sun
三十年	sen
三四天	sst
三四年	ssn
随你吧	snb
松口气	skq
私家车	sji
私家菜	sjc
三岔路	sil
算个屁	sgp
三个半	sgb
三方面	sfm
三不沾	sbv
随便了	sbl
台湾省	twu
体温计	twj
台湾岛	twd
通知书	tvu
挺适合	tug
淘汰赛	tts
挺容易	try
他妈的	tmd
太累了	tll
挺厉害	tlh
桃花运	thy
挺好用	thy
钛合金	tgj
太贵了	tgl
太过分	tgf
挺贵的	tgd
通风管	tfg
挺方便	tfb
听不清	tbq
听不出	tbi
通不过	tbg
少一些	uys
上下班	uxb
双下巴	uxb
生物钟	uwv
上午好	uwh
试试吧	uub
失去了	uql
说清楚	uqi
耍贫嘴	upz
商品房	upf
生力军	ulj
耍花腔	uhq
顺风耳	ufe
闪电战	udv
守财奴	ucn
殊不知	ubv
手把手	ubu
说不说	ubu
社保局	ubj
说不好	ubh
主要是	vyu
这一天	vyt
这一块	vyk
找一个	vyg
直辖市	vxu
真心话	vxh
赚外快	vwk
中午好	vwh
执政党	vvd
摘桃子	vtz
猪头肉	vtr
真他妈	vtm
主人翁	vrw
准确率	vql
正前方	vqf
中年人	vnr
蒸馏水	vlu
着凉了	vll
浙江省	vju
张家界	vjj
主持人	vir
中关村	vgc
正方形	vfx
战斗机	vdj
准备了	vbl
真不错	vbc
问一下	wyx
晚一步	wyb
五星级	wxj
娃娃脸	wwl
玩完了	wwl
尾椎骨	wig
晚上好	wuh
委托书	wtu
五禽戏	wqx
雾蒙蒙	wmm
物联网	wlw
玩两天	wlt
五六年	wln
完成了	wil
温哥华	wgh
五分钟	wfv
稳定性	wdx
完蛋了	wdl
误操作	wcz
玩不玩	wbw
小姨子	xyz
协议书	xyu
吸引人	xyr
幸运儿	xye
下午好	xwh
小叔子	xuz
小市民	xum
相似度	xsd
想清楚	xqi
小朋友	xpy
下坡路	xpl
小拇指	xmv
许可证	xkv
新纪元	xjy
新华社	xhu
喜欢吗	xhm
学会了	xhl
习惯上	xgu
小高层	xgc
媳妇儿	xfe
学到老	xdl
闲得慌	xdh
小地方	xdf
羞答答	xdd
小聪明	xcm
香饽饽	xbb
扬子鳄	yze
优越性	yyx
饮用水	yyu
一夜情	yyq
音乐会	ylh
亚细亚	yxy
鱼腥草	yxc
有问题	ywt
圆舞曲	ywq
以至于	yvy
一盏灯	yvd
右上角	yuj
于是乎	yuh
阴森森	yss
一片片	ypp
圆明园	ymy
一码事	ymu
虞美人	ymr
娱乐性	ylx
原来是	ylu
一块钱	ykq
研究所	yjs
阴沉沉	yii
颐和园	yhy
鱼肝油	ygy
一个梦	ygm
一公分	ygf
应该的	ygd
一个半	ygb
预付款	yfk
幺蛾子	yez
一大波	ydb
也不错	ybc
阴暗面	yam
啧啧啧	zzz
座右铭	zym
增长率	zil
座上客	zuk
左上角	zuj
早上好	zuh
责任心	zrx
最起码	zqm
怎么做	zmz
怎么写	zmx
怎么玩	zmw
怎么看	zmk
怎么查	zmi
怎么搞	zmg
怎么读	zmd
坐落在	zlz
钻空子	zkz
综合性	zgx
杂货铺	zhp
自豪感	zhg
自顾自	zgz
总公司	zgs
自动化	zdh
比翼齐飞	byqf
屏息凝神	bxnu
不外如是	bwru
屏住呼吸	bvhx
不停的说	btdu
不良资产	blzi
变来变去	blbq
不可替代	bktd
不可分割	bkfg
百看不厌	bkby
不讲义气	bjyq
不绝于耳	bjye
别具匠心	bjjx
不记得了	bjdl
不即不离	bjbl
不敢相信	bgxx
包工包料	bgbl
百废俱兴	bfjx
步调一致	bdyv
不得要领	bdyl
本本分分	bbff
不谙世事	bauu
此长彼消	cibx
惨淡经营	cdjy
多嘴多舌	dzdu
地主之谊	dvvy
大书特书	dutu
东瞧西看	dqxk
冬暖夏凉	dnxl
独门独户	dmdh
电光石火	dgdh
打发时间	dfuj
兜兜转转	ddvv
大道至简	ddvj
石沉大海	didh
十分之一	efvy
奉为楷模	fwjm
放手一搏	fuyb
飞来飞去	flfq
非常感谢	figx
富国强兵	fgjb
愤愤不平	ffbp
各有利弊	gylb
各有侧重	gyci
规行矩步	ghjb
孤身一人	guyr
果实累累	gull
高台跳水	gttu
故土难离	gtnl
寡廉鲜耻	glxi
高楼大厦	gldu
过街老鼠	gjlu
干劲冲天	gjit
古道热肠	gdri
光彩夺目	gcdm
合久必分	gjbf
话音未落	hywl
横行无忌	hhmj
混淆是非	hxuf
活血化瘀	hxhy
活学活用	hxhy
化学反应	hxfy
会者不难	hvbn
欢声雷动	huld
好说歹说	hudu
红头文件	htwj
话里话外	hlhw
横空出世	hkiu
好久不见	hjbj
好吃好喝	hihh
花花绿绿	hhll
恍恍惚惚	hhhh
花繁叶茂	hfxm
厚德载物	hdzw
河东狮吼	hduh
寒冬腊月	hdly
红白喜事	hbxu
毫不留情	hblq
重装系统	ivjt
赤身裸体	iult
成双成对	iuid
处事不惊	iubj
重起炉灶	iqlz
春节快乐	ijkl
彻彻底底	iidd
春花秋月	ihqy
春华秋实	ihqu
长话短说	ihdu
超凡脱俗	ifts
乘风破浪	ifpl
春风满面	ifmm
种族歧视	izqu
寄予厚望	jyhw
近乡情怯	jxqq
尽心尽力	jxjl
居心何在	jxhz
匠心独具	jxdj
教职员工	jvyg
假手于人	juyr
计上心来	juxl
九省通衢	jutq
见识浅薄	juqb
精神抖擞	juds
交通枢纽	jtun
惊人之举	jrvj
尽人皆知	jrjv
尽情发挥	jqfh
艰苦卓绝	jkvj
精诚团结	jitj
精诚所至	jisv
绝处逢生	jifu
家常便饭	jibf
疾风暴雨	jfby
就地正法	jdvf
急不可耐	jbkn
久别重逢	jbif
见不得人	jbdr
其心必异	jxby
其奈我何	jnwh
其疾如风	jjrf
可以燎原	kyly
看了一眼	klyy
苦大仇深	kdiu
看不顺眼	kbuy
另做打算	lzds
燎原之势	lyvu
洛阳纸贵	lyvg
联系联系	ljlj
联系电话	ljdh
路途遥远	ltyy
牢骚满腹	lsmf
令人振奋	lrvf
令人惊喜	lrjx
令人齿冷	lril
令人感动	lrgd
令人反感	lrfg
令人不解	lrbj
来去如风	lqrf
郎情妾意	lqqy
朗朗上口	lluk
零零碎碎	llss
来来去去	llqq
锣鼓喧天	lgxt
狼狈万状	lbmv
聊表寸心	lbcx
名言警句	myjg
绵延不断	mybd
没事找事	muvu
妙手空空	mukk
门庭冷落	mtll
名门世家	mmuj
目光如炬	mgrj
漫步其中	mbjv
万语千言	myqy
万水千山	muqu
无商不奸	mubj
无肉不欢	mrbh
无名英雄	mmyx
万里之遥	mlvy
万壑争流	mhvl
难者不会	nvbh
年少有为	nuyw
年纪轻轻	njqq
漂漂亮亮	ppll
蓬蓬勃勃	ppbb
破口大骂	pkdm
破家县令	pjxl
排除异己	piyj
平地风波	pdfb
屁大点事	pddu
骗财骗色	pcps
轻言细语	qyxy
趣味相投	qwxt
亲上加亲	qujq
秋收冬藏	qudc
求神拜佛	qubf
切切实实	qquu
亲戚朋友	qqpy
茕茕孑立	qqjl
权倾朝野	qqiy
齐齐哈尔	qqhe
千难万难	qnmn
青面獠牙	qmly
青睐有加	qlyj
巧立名目	qlmm
曲不离口	qblk
如诗如画	rurh
如花美眷	rhmj
死要面子	symz
似水流年	suln
酸了吧唧	slbj
死而不僵	sebj
色胆包天	sdbt
甜甜蜜蜜	ttmm
天理昭昭	tlvv
添丁增口	tdzk
听不清楚	tbqi
施以援手	uyyu
上下左右	uxzy
顺我者昌	uwvi
伤势未愈	uuwy
审时度势	uudu
拾金不昧	ujbm
尚方宝剑	ufbj
止增笑耳	vzxe
止于唇齿	vyii
这样都行	vydh
直系亲属	vjqu
铮铮铁骨	vvtg
终身大事	vudu
转来转去	vlvq
这话说的	vhud
枕戈待旦	vgdd
指腹为婚	vfwh
知法犯法	vfff
咋不知道	vbvd
问寒问暖	whwn
威风扫地	wfsd
我不犯人	wbfr
享有盛誉	xyiy
悬崖峭壁	xyqb
悬崖勒马	xylm
絮絮叨叨	xxdd
修修补补	xxbb
心中无数	xvmu
心神恍惚	xuhh
心神不宁	xubn
形容枯槁	xrkg
旭日东升	xrdu
血盆大口	xpdk
蓄谋已久	xmyj
笑脸相迎	xlxy
血流成河	xlih
小惩大诫	xidj
犹犹豫豫	yyyy
炎炎夏日	yyxr
异于常人	yyir
晕晕乎乎	yyhh
一拥而入	yyer
欲仙欲死	yxys
洋为中用	ywvy
一直以来	yvyl
言之尚早	yvuz
亦师亦友	yuyy
有说有笑	yuyx
远胜于我	yuyw
鱼水之欢	yuvh
应试教育	yujy
引蛇出洞	yuid
有伤风化	yufh
移山倒海	yudh
一声不吭	yubh
有头有脸	ytyl
有头没脑	ytmn
油头滑脑	ythn
摇头摆尾	ytbw
以势压人	yuyr
音容笑貌	yrxm
阅人无数	yrmu
一日不见	yrbj
阴晴圆缺	yqyq
眼皮底下	ypdx
有模有样	ymyy
一脉相承	ymxi
眼冒金星	ymjx
榆木疙瘩	ymgd
有理有据	ylyj
以儆效尤	yjxy
眼疾手快	yjuk
月经不调	yjbd
越扯越远	yiyy
又臭又硬	yiyy
一唱一和	yiyh
寅吃卯粮	yiml
有话快说	yhku
羽化登仙	yhdx
于公于私	ygys
应该说是	yguu
邀功请赏	ygqu
鸢飞鱼跃	yfyy
有胆有识	ydyu
一带一路	ydyl
愿赌服输	ydfu
药到病除	ydbi
拥兵自重	ybzi
有板有眼	ybyy
仪表堂堂	ybtt
一表人才	ybrc
愚不可及	ybkj
一般见识	ybju
自有分寸	zyfc
走着走着	zvzv
作声不得	zubd
自强自立	zjzl
自成一体	ziyt
纵横驰骋	zhii
坐等其成	zdji
不是冤家不聚头	buyt
比上不足，比下有余	buby
不入虎穴，焉得虎子	brhz
不当家不知柴米贵	bdjg
不到黄河心不死	bdhs
拆东墙，补西墙	cdqq
打蛇随棍上	dusu
读书破万卷	dupj
打错了算盘	dclp
狗眼看人低	gykd
狗改不了吃屎	ggbu
光打雷不下雨	gdly
横挑鼻子竖挑眼	htby
坏了一锅粥	hlyv
成也萧何，败也萧何	iyxh
仇人相见，分外眼红	irxh
吃亏在眼前	ikzq
重赏之下，必有勇夫	iuvf
井水不犯河水	jubu
己所不欲，勿施于人	jsbr
尽人事听天命	jrum
旧瓶装新酒	jpvj
吉尔吉斯斯坦	jejt
雷声大，雨点小	ludx
两国交兵，不斩来使	lgju
明知山有虎，偏向虎山行	mvuh
名不正言不顺	mbvu
无规矩不成方圆	mgjy
拿得起放得下	ndqx
穷山恶水出刁民	quem
投资回报率	tzhl
兔子不吃窝边草	tzbc
身在曹营心在汉	uzch
失之东隅，收之桑榆	uvdy
身正不怕影子斜	uvbx
授人以鱼，不如授人以渔	uryy
舍不得孩子套不住狼	ubdl
睁一只眼，闭一只眼	vyvy
竹篮打水一场空	vldk
针尖对麦芒	vjdm
以小人之心，度君子之腹	yxrf
一心不能二用	yxby
有志者事竟成	yvvi
一日为师，终生为父	yrwf
用人不疑，疑人不用	yrby
以其人之道，还治其人之身	yjru
一力降十会	yljh
一行白鹭上青天	yhbt
一个愿打，一个愿挨	ygya
艺多不压身	ydbu
一动不如一静	ydbj
