---config@码表分类=主码-4
---config@码表别名= 增补字
爱咋咋地	avvd
暗自庆幸	azqx
哎呦喂	ayww
安享晚年	axwn
按下葫芦起来瓢	axhp
安身之所	auvs
爱谁谁	auuv
凹凸有致	atyv
安然自若	arzr
安然无事	armu
安然入睡	arru
安然入眠	arrm
安全性	aqxk
傲然	aorj
安歇	anxp
爱慕虚荣	amxr
挨门逐户	amvh
按常理来说	ailu
按常理	aili
矮了	aile
隘口	aikz
艾灸	aijq
按道理	adli
熬不住	abvu
熬不过	abgo
阿嚏	aati
阿訇	aahs
阿公	aags
阿伯	aabd
阿其所好	ajsh
拗不过	abgo
百足之虫，死而不僵	bzvj
不吱声	bvug
不在其位，不谋其政	bzjv
不早了	bzle
不醉不归	bzbg
不言自明	byzm
别有一番风味	byyw
别有一番	byyf
鲍鱼之肆	byvs
比翼齐飞	byqf
不用了	byle
必有近忧	byjy
不用担心	bydx
不由得	byde
宝相庄严	bxvy
笔下生花	bxuh
屏息凝神	bxnu
不懈努力	bxnl
本小利大	bxld
悲喜剧	bxju
别瞎扯	bxie
八仙过海，各显神通	bxgt
八仙过海，各显其能	bxgn
不宣而战	bxev
不幸而言中	bxev
本相毕露	bxbl
不行吧	bhba
别无他途	bmtt
不外如是	bwru
背弃	bwqi
悲凉	bwll
北疆	bwjl
不忘初心	bwix
备货	bwho
北伐	bwfa
北段	bwdr
不无道理	bmdl
不指望	bvwh
不知死活	bvsh
不追求	bdqq
不斩来使	bvlu
不支持了	bvil
屏住呼吸	bvhx
不知高低	bvgd
不知凡几	bvfj
不是冤家不聚头	buyt
不是鱼死，就是网破	buyp
补休	buxq
补习	buxi
布阵	buvf
步态	butd
不俗	busu
背山面水	bumu
布控	buks
不是吃素的	buid
不施粉黛	bufd
不守妇道	bufd
不舒服	bufu
辨识度	budo
不识大体	budt
步调	budn
布袋	budd
比上不足，比下有余	buby
百试百灵	bubl
不太赞成	btzi
不太喜欢	btxh
不太习惯	btxg
别太晚了	btwl
别太晚	btwj
不太熟悉	btux
不太适合	btug
不太舒服	btuf
半桶水，响叮当	btud
不太认识	btru
不太认同	btrt
不通人情	btrq
不通情理	btql
不听劝	btqr
不太满意	btmy
不听老人言	btly
不听老人言，吃亏在眼前	btlq
并蹄莲	btlm
抱头乱串	btli
不痛快	btkk
不太看好	btkh
不太好看	bthk
不太好吧	bthb
不太高兴	btgx
不太敢	btgj
别太过分	btgf
不太方便	btfb
白天鹅	btee
不停的说	btdu
不太安全	btaq
比死人多口气	bsrq
不如意事常八九	bryj
不如授人以渔	bruy
不然呢	brne
被人卖了还帮着数钱	brmq
不入虎穴，焉得虎子	brhz
不求闻达于诸侯	bqwh
霸权主义	bqvy
病去如抽丝	bqrs
不平则鸣	bpzm
不怕一万，就怕万一	bpyy
不怕一万	bpym
不便宜	bbyi
半瓶水响叮当	bpud
不怕没柴烧	bpmu
不怕不识货	bpbh
波音	boyb
搏击	boji
博彩	bocd
博鳌	boao
表姨	bnyi
白内障	bnvh
表叔	bnuu
表婶	bnuf
别闹了	bnle
标间	bnjm
标号	bnhc
表单	bndj
贬义	bmyi
不满意	bmyi
兵马未动，粮草先行	bmwh
贬值	bmvi
不明事理	bmul
闭目塞听	bmst
便签	bmqm
笔墨官司	bmgs
不良资产	blzi
表里一致	blyv
白龙鱼服	blyf
玻璃纤维	blqw
不理想	blxl
别来这一套	blvt
不虑胜先虑败	blub
不论是	blui
波澜起伏	blqf
摆龙门阵	blmv
贝雷帽	blmc
玻璃杯	blbw
变来变去	blbq
不堪造就	bkzj
不可懈怠	bkxd
不可外扬	bkwy
冰柱	bkvu
不可知论	bkvl
不可替代	bktd
不可全信	bkqx
冰凌	bklk
不可抗力	bkkl
冰晶	bkjk
冰寒	bkhj
兵符	bkfu
不可分割	bkfg
兵丁	bkdk
百看不厌	bkby
不可不知	bkbv
不讲义气	bjyq
八九月份	bjyf
不绝于耳	bjye
百家姓	bjxk
不尽完美	bjwm
不见真佛不烧香	bjvx
半途	bjtu
不近情理	bjql
不拘泥于	bgny
不讲面子	bjmz
办卡	bjka
别具匠心	bjjx
半斤	bjjb
不教而诛	bjev
不记得了	bjdl
搬到	bjdc
半岛	bjdc
不即不离	bjbl
笔记本	bjbf
不吃羊肉惹身臊	biys
辟邪	bixp
笔筒	bits
笔谈	bitj
半成品	bipb
不扯了	bile
必考	bikc
壁橱	biiu
闭环	bihr
壁挂	bigx
鼻窦	bidz
不合适	bgui
绑腿	bhtv
暴虎冯河	bhfh
冰火两重天	bhlt
白鹤亮翅	beli
不敢相信	bgxx
悲观主义	bgvy
百舸争流	bgvl
不够塞牙缝	bgsf
帮个忙	bgmh
不干胶	bgjn
不甘后人	bghr
拔根汗毛比腰粗	bghc
不管不问	bgbw
包工包料	bgbl
不放在眼里	bfzl
本源	bfyr
变法维新	bfwx
不服气	bfqi
兵分两路	bfll
百废俱兴	bfjx
不复当年	bfdn
百分点	bfdm
不二法则	befz
半吊子	bdzi
柏油	bdyz
不得有误	bdyw
步调一致	bdyv
不得要领	bdyl
拜堂	bdth
白猫	bdmc
帮倒忙	bdmh
败露	bdlu
背地里	bdli
不当家不知柴米贵	bdjg
不到黄河心不死	bdhs
摆放	bdfh
不得不低头	bdbt
不得不服	bdbf
豹子	bczi
褒义	bcyi
包退	bctv
病从口入，祸从口出	bcki
包抄	bcic
不把自己当外人	bbzr
并不想	bbxl
卑鄙无耻	bbmi
摆摆手	bbuz
并不能	bbng
帮帮忙	bbmh
把把脉	bbmd
步步莲花	bblh
必不可缺	bbkq
滨江	bbjl
并不会	bbhv
本本分分	bbff
包办代替	bbdt
斑斑点点	bbdd
不谙世事	bauu
不安全	baqr
八两	ball
芭蕉	bajn
不按常理出牌	baip
不按常理	bail
寸有所长	cysi
参与度	cydo
雌雄异体	cxyt
才需要	cxyc
雌雄同体	cxtt
此消彼长	cxbi
翠微	cvww
财政危机	cvwj
财政税收	cvuu
藏之名山，传之其人	cvmr
此长彼消	cibx
醋味	cuww
此时无声胜有声	cumu
此生无憾	cumh
藏身之地	cuvd
才疏识浅	cuuq
残汤剩饭	ctuf
从头开始	ctku
寸土寸金	ctcj
沧桑坎坷	cskk
翠绕珠围	crvw
从轻处置	cqiv
聪明人	cmrf
层林尽染	cljr
猜来猜去	clcq
残影	cjyk
残雪	cjxt
葱姜蒜	cjsr
此列	cilp
此话	cihx
此行	cihh
蹭吃蹭喝	cich
摧城拔寨	cibv
慈航普度	chpd
挫骨扬灰	cgyh
蹭吃	cgii
蹭车	cgie
此风不可长	cfbi
此地无银	cdmy
菜品	cdpb
菜农	cdns
财迷	cdmi
惨淡经营	cdjy
从刀尖上爬过来的	cdjd
彩灯	cddg
漕运	ccyy
草草收尾	ccuw
残次品	ccpb
擦擦汗	cchj
层层叠叠	ccdd
才不至于	cbvy
草本植物	cbvw
藏不住	cbvu
寸步难移	cbny
擦药	cayc
擦鞋	caxp
擦手	cauz
擦脸	calm
擦脚	cajn
拆东墙，补西墙	cdqq
差钱	ciqm
伺机而动	cjed
都在玩	dzwj
地藏王	dcwh
打嘴仗	dzvh
弟子服其劳	dzfl
多嘴多舌	dzdu
得益于	dyyu
大音希声	dyxu
多一些	dyso
第一桶金	dytj
大雨瓢泼	dypp
单眼皮	dypi
东一榔头西一棒子	dylz
等于零	dylk
钝化	dyhx
单引号	dyhc
第一反应	dyfy
大象无形	dxmx
打小算盘	dxsp
掉下去	dxqu
刀削面	dxmm
大限将至	dxjv
大雪纷飞	dxff
东向而望，不见西墙	dxeq
对外贸易	dwmy
当我没说	dwmu
敌我矛盾	dwmd
对外开放	dwkf
跌无可跌	dmkd
党中央	dvyh
地主之谊	dvvy
大致说来	dvul
大战三百回合	dvsg
打着灯笼找不着	dvdv
低声细语	duxy
堵心	duxb
董事长	duih
大书特书	dutu
肚痛	duts
打蛇随棍上	dusu
读书破万卷	dupj
渡劫	dujp
大事化小，小事化了	duhl
大使馆	dugr
肚兜	dudz
对事不对人	dubr
独特性	dtxk
打听打听	dtdt
爹死娘嫁人，各人顾各人	dsnr
抖擞精神	dsju
东段	dsdr
单丝不成线	dsbx
淡若清风	drqf
端木	drmu
打入冷宫	drlg
端人家碗，受人家管	drjg
单人床	dril
大人不记小人过	drbg
东瞧西看	dqxk
刀枪入库	dqrk
冬去春来	dqil
得便宜卖乖	dbyg
东跑西颠	dpxd
大排档	dpdh
冬暖夏凉	dnxl
吊索	dnso
东南风	dnfg
大难不死，必有后福	dnbf
电箱	dmxl
多面手	dmuz
当面是人，背后是鬼	dmug
大忙人	dmrf
垫圈	dmjr
颠沛	dmpw
点开	dmkd
打马虎眼	dmhy
电柜	dmgv
电工	dmgs
当面鼓对面锣	dmgl
独门独户	dmdh
点错	dmco
砥砺前行	dlqh
打了鸡血	dljx
大路朝天，各走一边	dlib
定了定神	dldu
得来不易	dlby
盯死	dksi
顶楼	dklz
顶灯	dkdg
定睛一看	djyk
待机时间	djuj
渡尽劫波兄弟在	djjz
堆金积玉	djjy
断简残编	djcb
滴酒不沾	djbv
单边	djbm
低效	dixn
地势	deui
底气	diqi
倒插门	dimf
低端	didr
东海扬尘	dhyi
导火线	dhxm
档期	dhji
动画片	dhpm
灯箱	dgxl
达官显贵	dgxg
电光石火	dgdh
顶个屁用	dgpy
倒挂金钟	dgjv
倒挂金钩	dgjg
刀耕火种	dghi
打狗还得看主人	dghr
等边	dgbm
顶风作案	dfza
大方无隅	dfmy
挡风遮雨	dfvy
豆腐渣工程	dfvi
大发善心	dfux
打发时间	dfuj
大富大贵	dfdg
等而下之	dexv
大而无当	demd
当耳旁风	depf
得而复失	defu
兜兜转转	ddvv
大打折扣	dduk
大道至简	ddvj
点点头	ddtz
打打闹闹	ddnn
嘟嘟囔囔	ddnn
弟弟妹妹	ddmm
躲得了初一躲不过十五	ddlw
堵得慌	ddhl
代购	ddgz
点灯熬油	dday
倒叙	dcxu
倒桩	dcvl
打错了算盘	dclp
捯饬	dcii
到付	dcfu
貂不足，狗尾续	dbzx
单兵作战	dbzv
都不一样	dbyy
大白于天下	dbyx
大病一场	dbyi
都不喜欢	dbxh
打不着狐狸惹身骚	dbvs
道不拾遗	dbuy
倒不是	dbui
代表团	dbtr
大白天说梦话	dbth
大白若辱	dbrr
大病初愈	dbiy
对比度	dbdo
断编残简	dbcj
打坐	dazo
大侠	daxx
大仙	daxm
打完	dawj
大师	daui
大屏	dabk
大佬	dalc
搭车	daie
大号	dahc
鸟用	dnys
鸟样	dnyh
鸟窝	dnwo
鸟兽	dnuz
鸟枪	dnql
鸟粪	dnff
叨陪末座	dpmz
调仓	dnch
提出来	dild
提点	didm
石墨烯	dmxi
石沉大海	didh
追亡逐北	dwvb
追兵	dvbk
恶语相向	eyxx
恩怨是非	eyuf
二选一	exyi
二者必居其一	evby
二者不可得兼	evbj
二十年	eenm
耳听为虚，眼见为实	etwu
二三月份	esyf
饿死胆小的	esdd
耳软心活	erxh
二人世界	eruj
二回	erhv
二笔	erbi
儿女情长，英雄气短	enqd
耳目众多	emvd
二郎腿	eltv
二合一	egyi
二话不说	ehbu
二道贩子	edfz
儿大不由娘	edbn
儿不嫌母丑，狗不嫌家贫	ebxp
二不跨五	ebkw
二八法则	ebfz
二八定律	ebdl
十一二月	eyey
十位数	ewuu
十指连弹	evld
十里不同俗	elbs
十分之一	efvy
复杂性	fzxk
飞扬小鹤	fyxe
腹有诗书气自华	fyuh
敷衍塞责	fysz
佛要金装	fyjv
蜉蝣撼大树	fyhu
风雨不透	fybt
焚香沐浴	fxmy
费心费力	fxfl
风向标	fxbn
芳心暗许	fxax
服务器	fwqi
反误了卿卿性命	fwlm
奉为楷模	fwjm
附赘悬疣	fvxy
负债累累	fvll
放手一搏	fuyb
抚慰	fuww
附着	fuvc
复牌	fupd
赴美	fumw
父老	fulc
复查	fuia
伏虎	fuhu
腹稿	fugc
凡人不可貌相	frbx
富强发达	fjfd
夫妻店	fqdm
放弃吧	fqba
发脾气	fpqi
服你了	fnle
飞鸟尽良弓藏	fdjc
防民之口，甚于防川	fmvi
反面人物	fmrw
负面情绪	fmqx
发霉了	fmle
反面教材	fmjc
放马后炮	fmhb
放马过来	fmgl
发牢骚	flsc
服了你了	flnl
风里来，雨里去	fllq
飞来飞去	flfq
翻脸不认人	flbr
放浪不羁	flbj
氟利昂	flah
佛口蛇心	fkux
防君子不防小人	fjzr
富甲一方	fjyf
福建省	fjug
抚今思昔	fjsx
风景区	fjou
翻盘	fjpj
番邦	fjbh
分久必合	fjbg
非常重要	fiiy
房产证	fivg
风吹日晒	firu
非常感谢	figx
房前	fhqm
防霉	fhmw
繁华落尽	fhlj
放浪	fhlh
防臭	fhiz
方管	fhgr
蜂王	fgwh
富国强兵	fgjb
富贵花开	fghk
风高放火天	fgft
风高放火	fgfh
方方正正	ffvv
分针	ffvf
泛泛之辈	ffvb
发发牢骚	ffls
粉底	ffdi
愤愤不平	ffbp
飞蛾投火	feth
风大雨大	fdyd
风刀霜剑	fduj
妇道人家	fdrj
防毒面具	fdmj
福大命大	fdmd
反编译	fbyi
法兰	falj
发件	fajm
故作姿态	gzzt
狗嘴吐不出象牙	gzty
个子高高	gzgg
苟安	gzan
歌以咏志	gyyv
古已有之	gyyv
工欲善其事，必先利其器	gyuq
过一天算一天	gytt
各有利弊	gylb
狗眼看人低	gykd
各有侧重	gyci
感性认识	gxru
隔靴挠痒	gxny
更新了	gxle
规行矩步	ghjb
关系户	gjhu
挂掉	gxdn
国务卿	gwqk
柜员	gvyr
皈依	gvyi
规章制度	gvvd
根正苗红	gvmh
归集	gvji
归真返璞	gvfp
高枕而卧	gvew
孤身一人	guyr
观世音	guyb
姑息	guxi
盖世太保	gutb
果实累累	gull
骨架	gujx
过山车	guie
故事梗概	gugg
国事访问	gufw
共同市场	gtui
高台跳水	gttu
故土难离	gtnl
国土局	gtju
共识	gsui
甘肃省	gsug
公婆	gspo
贡品	gspb
公粮	gsll
攻克	gske
共处	gsiu
公会	gshv
功过	gsgo
公私分明	gsfm
宫娥	gsee
工段	gsdr
工人阶级	grjj
关东	grds
管材	grcd
苟全性命于乱世	gqxu
攻其无备	gjmb
苟且偷安	gjta
顾盼自雄	gpzx
公平性	gpxk
割袍断义	gpdy
过站	govj
果糖	goth
果盘	gopj
果酒	gojq
国内外	gnwd
姑奶奶	gnnd
敢怒敢言	gngy
广袤无垠	gmmy
革命尚未成功，同志仍需努力	gmul
革命尚未成功	gmug
概莫能外	gmnw
根目录	gmlu
规模化	gmhx
鼓浪屿	glyu
寡廉鲜耻	glxi
格林威治	glwv
过了这个村就没这个店了	glvl
光秃	gltu
古里古怪	glgg
高楼大厦	gldu
搞了半天	glbt
公开信	gkxb
鬼哭神嚎	gkuh
公开赛	gksd
关节炎	gjyj
甘休	gjxq
国际主义	gjvy
过江之鲫	gjvj
管见所及	gjsj
过街老鼠	gjlu
感觉良好	gjlh
公积金	gjjb
甘醇	gjiy
干劲冲天	gjit
根据地	gjde
干才	gjcd
过程中	givs
刚出狼窝，又入虎口	gilk
观察力	gili
古惑仔	ghzd
搞混了	ghle
共和党	ghdh
搞搞震	ggvf
骨骼清奇	ggqj
关公面前耍大刀	ggmd
孤寡老人	gglr
改革创新	ggix
公共场所	ggis
狗改不了吃屎	ggbu
搞风搞雨	gfgy
苟富贵，勿相忘	gfgw
隔间	gejm
高尔夫球	gefq
公道自在人心	gdzx
改选	gdxr
各打五十大板	gdwb
扛鼎之作	gdvz
古典主义	gdvy
古道热肠	gdri
光打雷不下雨	gdly
高等教育	gdjy
搞东搞西	gdgx
高一	gcyi
高三	gcsj
高冷	gclg
高工	gcgs
搞鬼	gcgv
高二	gcer
光彩夺目	gcdm
更不用说	gbyu
鬼不像鬼	gbxg
胳膊肘往外拐	gbvg
更别说	gbuo
搞半天	gbtm
更不能	gbng
更不可能	gbkn
赶不及	gbji
高矮胖瘦	gapu
合理性	glxk
合久必分	gjbf
合成纤维	giqw
合乎逻辑	ghlj
句句在理	ggzl
涡轮	goly
莞尔一笑	geyx
后仰	hzyh
候诊	hzvf
后山	hzuj
洪泽湖	hzhu
汉贼不两立	hzbl
花园洋房	hyyf
话音未落	hywl
荒淫无度	hymd
好一阵子	hyvz
后院起火	hyqh
获益良多	hyld
鸿雁传书	hyiu
行有行规	hyhg
诲淫诲盗	hyhd
混搭	hyda
花样百出	hybi
好戏在后头	hxzt
横行无忌	hhmj
花猪	hxvu
混淆是非	hxuf
欢欣雀跃	hxqy
滑腻	hxni
活血化瘀	hxhy
活学活用	hxhy
化学反应	hxfy
毫无怨言	hmyy
毫无预兆	hmyv
毫无征兆	hmvv
换位思考	hwsk
黑猫	hwmc
毫无办法	hmbf
会晤	hvwu
会审	hvuf
晦涩	hvse
蕙质兰心	hvlx
厚着脸皮	hvlp
回踩	hvcd
会者不难	hvbn
护眼	huyj
还手之力	huvl
户名	humk
呼噜	hulu
黄鼠狼给鸡拜年	huln
护栏	hulj
欢声雷动	huld
湖景	hujk
互换	huhr
好说歹说	hudu
护垫	hudm
昏睡百年	hubn
回头再说	htzu
回天无力	html
红头文件	htwj
昏头转向	htvx
活脱脱	htto
回头看看	htkk
黑天鹅	htee
撼天动地	htdd
横挑鼻子竖挑眼	htby
皇天不负有心人	htbr
互诉衷肠	hsvi
哄着	hsvc
红楼	hslz
红椒	hsjn
好死不如赖活	hsbh
换组	hrzu
害人之心不可有，防人之心不可无	hrvm
换回	hrhv
花入各眼	hrgy
活人不能让尿憋死	hrbs
换气扇	hquj
和气生财	hquc
魂牵梦系	hqmj
或轻或重	hqhi
海平面	hpmm
胡拼乱凑	hplc
黄埔军校	hbjj
狐朋狗党	hpgd
货单	hodj
湖南省	hnug
河南省	hnug
黄梅戏	hmxi
浩渺无垠	hmmy
灰蒙蒙	hmmg
坏毛病	hmbk
坏了一锅粥	hlyv
晃眼	hlyj
黄龙	hlls
话里话外	hlhw
慌里慌张	hlhv
惠灵顿	hldy
虎口脱险	hktx
横空出世	hkiu
混口饭吃	hkfi
花开富贵	hkfg
户口簿	hkbo
户口本	hkbf
行家一出手，就知有没有	hjyy
阖家幸福	hjxf
好几十年	hjen
汉唐	hjth
好几年	hjnm
好几回	hjhv
阖家欢乐	hjhl
撼动	hjds
好几次	hjci
好久不见	hjbj
阖家安康	hjak
横冲直闯	hivi
候车室	hiui
汗出如浆	hirj
好吃好喝	hihh
好处费	hifw
混吃等死	hids
好好学习，天天向上	hhxu
黄河之水天上来	hhvl
挥挥手	hhuz
好好说	hhuo
好好说话	hhuh
挥毫洒墨	hhsm
和和气气	hhqq
花花绿绿	hhll
花花轿子人抬人	hhjr
好合好散	hghs
恍恍惚惚	hhhh
哈哈哈	hhha
黄花菜都凉了	hhcl
好汉不提当年勇	hhby
好话不说二遍	hhbb
还好吧	hhba
好钢用在刀刃上	hgyu
花果山	hguj
和光同尘	hgti
红光满面	hgmm
哼哈	hgha
花骨朵	hgdo
厚古薄今	hgbj
花繁叶茂	hfxm
毫发无伤	hfmu
毫发无损	hfms
狠话	hfhx
菏泽	heze
喝点	hedm
花儿朵朵	hedd
厚德载物	hdzw
化敌为友	hdwy
荒诞无稽	hdmj
河东狮吼	hduh
寒冬腊月	hdly
皇帝轮流坐，明年到我家	hdlj
活到老	hdlc
海角	hdjn
海景	hdjk
何德何能	hdhn
好多次	hdci
好脏	hczh
好乱	hclr
好假	hcjx
浩劫	hcjp
好点	hcdm
互不影响	hbyx
花边新闻	hbxw
红白喜事	hbxu
毫不逊色	hbxs
话不说不明	hbum
还不少	hbuc
毫不留情	hblq
祸不及家人	hbjr
恨不得有条地缝钻进去	hbdq
后半辈子	hbbz
后半部分	hbbf
巷子	hhzi
行吗	hhma
行高于人，众必非之	hgyv
行不更名，坐不改姓	hbgx
行不更名	hbgm
行不得也哥哥	hbdg
臭嘴	izzv
创造性	izxk
成则为王，败则为寇	izwk
赤子之心	izvx
筹拍	izpd
瞅瞅	iziz
穿凿附会	izfh
初一一回十五一回	iyyh
成也萧何，败也萧何	iyxh
穿一条裤子	iytz
尺有所短	iysd
穿云破雾	iypw
产业革命	iygm
吃哑巴亏	iybk
程序员	ixyr
创新能力	ixnl
吃相难看	ixnk
重新开始	ixku
长效机制	ixjv
吃现成饭	ixif
丑媳妇总得见公婆	ixfp
成为一个	iwyg
颤巍巍	iwww
出问题	iwti
常委会	iwhv
朝中有人好做官	ivyg
重装系统	ivjt
吃着碗里，望着锅里	ivwl
吃着碗里的，望着锅里的	ivwd
称之为	ivww
晨钟暮鼓	ivmg
初夏	iuxx
初心	iuxb
出师未捷	iuwj
初始状态	iuvt
初秋	iuqq
抽水马桶	iumt
赤身裸体	iult
初略	iult
诚实可靠	iukk
除开	iukd
初春	iuiy
成双成对	iuid
出格	iuge
抽身而去	iueq
触动	iuds
成事不足，败事有余	iuby
处事不惊	iubj
秤砣虽小压千斤	itsj
出头露面	itlm
冲茶	isia
虫害	ishd
撑死胆大的	isdd
出人意外	iryw
出人意表	iryb
仇人相见，分外眼红	irxh
成仁取义	irqy
吃人家饭，受人家管	irjg
吃人家的嘴短	irjd
串场	irih
吃人不吐骨头	irbt
船舶	irbo
重起炉灶	iqlz
春秋鼎盛	iqdi
常年在外	inzw
处女作	inzo
传男不传女	inbn
吹牛不打草稿	inbg
出谋献策	imxc
城门失火，殃及池鱼	imuy
臣门如市	imru
愁眉泪眼	imly
程门立雪	imlx
崇明岛	imdc
出毛病了	imbl
豺狼虎豹	ilhb
查漏补缺	ilbq
吃亏在眼前	ikzq
春节快乐	ijkl
蟾蜍	ijiu
除旧布新	ijbx
尺子	iizi
吃些	iiso
吃香	iixl
彻彻底底	iidd
窗户纸一点就破	ihvp
丑话说在前头	ihut
春花秋月	ihqy
春华秋实	ihqu
长串	ihir
长话短说	ihdu
常德	ihde
唱本	ihbf
橙子	igzi
承销	igxn
撑伞	igsj
车轱辘话	iglh
撑杆	iggj
城防	igfh
承德	igde
乘风扬帆	ifyf
长方形	ifxk
趁手	ifuz
超凡脱俗	ifts
乘风破浪	ifpl
春风满面	ifmm
晨会	ifhv
尘垢	ifgz
春风拂面	iffm
车龄	ielk
撤防	iefh
撤单	iedj
吃得消	idxn
吹得天花乱坠	idtv
船到桥头自然直	idqv
吃得开	idkd
闯荡江湖	idjh
臭豆腐	idfu
超卓	icvo
超市	icui
春蚕到死丝方尽	icdj
吃不下饭	ibxf
沉不住气	ibvq
长白山	ibuj
唱白脸	iblm
常备不懈	ibbx
茶社	iaue
叉车	iaie
抢先一步	ixyb
抢戏	igxi
抢购一空	igyk
盛名之下无虚士	imvu
种族歧视	izqu
重心不稳	ixbw
重赏之下，必有勇夫	iuvf
长他人志气	itrq
长他人志气，灭自己威风	itrf
重伤	isuh
种类繁多	ilfd
重口味	ikww
长出	ihiu
长草	ihcc
君子一言，驷马难追	jzyd
君子远庖厨	jzyi
教子有方	jzyf
教子无方	jzmf
君子之交淡如水	jzvu
君子慎独	jzud
君子动口不动手	jzdu
尖嘴薄舌	jzbu
建言献策	jyxc
局域网	jywh
经一事，长一智	jyuv
节约时间	jyuj
技压群雄	jyqx
将欲取之，必先予之	jyqv
疾言厉色	jyls
寄予厚望	jyhw
家宴	jxyj
假惺惺	jxxk
江西省	jxug
甲醛	jxqr
近乡情怯	jxqq
佳酿	jxnl
锦绣年华	jxnh
假寐	jxmw
尽心尽力	jxjl
加急	jxji
家传	jxir
居心何在	jxhz
匠心独运	jxdy
匠心独具	jxdj
甲等	jxdg
加餐	jxcj
家财	jxcd
酒香不怕巷子深	jxbu
基围虾	jwxx
就为了	jwle
绝无二心	jmex
经纬度	jwdo
教职员工	jvyg
集装箱	jvxl
急转弯	jvwj
近朱者赤，近墨者黑	jvvh
价值千金	jvqj
君主立宪	jvlx
绝知此事要躬行	jvch
剧作	juzo
监守自盗	juzd
假手于人	juyr
九十月份	jeyf
计上心来	juxl
九省通衢	jutq
尽释前嫌	juqx
见识浅薄	juqb
精神可嘉	jukj
居后	juhz
拒付	jufu
精神抖擞	juds
井水不犯河水	jubu
精神百倍	jubb
矍铄	jtuo
交通枢纽	jtun
狡兔死走狗烹	jtsp
交通局	jtju
交通工具	jtgj
紧随其后	jsjh
急死了	jsle
己所不欲，勿施于人	jsbr
救人一命	jrym
近日无仇	jrmi
既然这样	jrvy
惊人之举	jrvj
尽人事听天命	jrum
见人说人话	jruh
节日快乐	jrkl
尽人皆知	jrjv
涓涓	jrjr
见人矮三分	jraf
久闻	jqwf
敬请期待	jqjd
捡起来	jqld
舅舅	jqjq
尽情发挥	jqfh
金盆洗手	jpxu
就怕万一	jpmy
旧瓶装新酒	jpvj
吉普赛	jpsd
接盘	jppj
解禁	jpjb
解惑	jpho
就怕货比货	jphh
解绑	jpbh
骄纵	jnzs
今年以来	jnyl
叫嚣	jnxn
交投	jntz
纪念日	jnri
娇气	jnqi
箭镞	jmzu
健硕	jmuo
奸商	jmuh
检票	jmpn
键帽	jmmc
今明两年	jmln
简练	jmlm
间或	jmho
减分	jmff
简明扼要	jmey
见底	jmdi
见地	jmde
剪刀	jmdc
将至	jlvi
吉林省	jlug
姜蒜	jlsr
匠人	jlrf
讲求	jlqq
戒律清规	jlqg
积劳成疾	jlij
浆糊	jlhu
精力过剩	jlgu
降格	jlge
降幅	jlfu
加勒比	jlbi
接力棒	jlbh
精油	jkyz
经用	jkys
镜像	jkxl
精细	jkxi
敬重	jkis
艰苦卓绝	jkvj
净水	jkuv
竞速	jksu
艰苦朴素	jkps
交口称赞	jkiz
缄口不言	jkby
经济危机	jjwj
结结实实	jjuu
经济实惠	jjuh
竞技体育	jjty
嫁鸡随鸡，嫁狗随狗	jjsg
急急如律令	jjrl
积极进取	jjjq
加减法	jjfa
记性	jixk
挤占	jivj
击杀	jiua
精诚团结	jitj
精诚所至	jisv
积弱	jiro
绝处逢生	jifu
荠菜	jicd
家常便饭	jibf
积毁销骨	jhxg
姜还是老的辣	jhul
酒后吐真言	jhty
几何图形	jhtx
监护人	jhrf
饥寒起盗心	jhqx
江湖骗子	jhpz
计划没有变化快	jhmk
就好了	jhle
菊花茶	jhia
简化汉字	jhhz
计划赶不上变化	jhgh
京杭大运河	jhdh
家花不如野花香	jhbx
计划不如变化快	jhbk
就好比	jhbi
巾帼英雄	jgyx
技高一筹	jgyi
军国主义	jgvy
金光闪闪	jguu
见鬼说鬼话	jguh
举国同庆	jgtq
机关算尽太聪明	jgsm
结果如何	jgrh
几个钱	jgqm
举个例	jgli
几个来回	jglh
加工厂	jgih
几个回合	jghg
几个方面	jgfm
巾帼不让须眉	jgbm
疾风迅雷	jfxl
绝非善类	jful
疾风扫落叶	jfsx
绝非偶然	jfor
街坊邻居	jflj
见缝就钻	jfjz
结发夫妻	jffq
奖罚分明	jffm
疾风暴雨	jfby
吉尔吉斯斯坦	jejt
筋斗云	jdyy
就地正法	jdvf
剪刀石头布	jddb
鸡蛋碰石头	jdpt
讲道理	jdli
既当爹又当妈	jddm
旧的不去，新的不来	jdbl
饥餐渴饮	jcky
酒不醉人人自醉	jbzz
简便易行	jbyh
锦绣	jbxq
进项	jbxl
久病无孝子	jbmz
戒备森严	jbsy
即便如此	jbrc
记不清	jbqk
急不可耐	jbkn
近看	jbkj
揭不开锅	jbkg
久别重逢	jbif
金叉	jbia
绝不会	jbhv
金贵	jbgv
绝不放手	jbfu
金发	jbfa
见不得人	jbdr
记不得了	jbdl
禁播	jbbo
强有力	jyli
其心必异	jxby
强中自有强中手	jvzu
圈点	jrdm
其奈我何	jnwh
奇技淫巧	jjyq
其疾如风	jjrf
奇花异木	jhym
降龙	jlls
降龙伏虎	jlfh
系数	jiuu
捆扎	kyva
枯鱼之肆	kyvs
客运站	kyvj
可与人言无二三	kyrs
可以燎原	kyly
可以攻玉	kygy
空心菜	kxcd
开枝散叶	kvsx
溃散	kvsj
控制面板	kvmb
开山祖师	kuzu
酷炫	kuxr
犒赏三军	kusj
苦荞	kuqn
跨时代	kudd
开山鼻祖	kubz
磕头碰脑	ktpn
控油	ksyz
空港	ksgh
看清楚	kqiu
看清楚了	kqil
扩增	kozg
枯木死灰	kmsh
开门红	kmhs
看了一眼	klyy
看了一下	klyx
狂泻	klxp
苦辣酸甜	klst
矿难	klnj
矿脉	klmd
可了不得	klbd
看看再说	kkzu
开阔视野	kkuy
块垒	kklw
坎坷不平	kkbp
开口闭口	kkbk
看去	kjqu
砍价	kjjp
看房	kjfh
可见度	kjdo
堪称一绝	kiyj
开诚相见	kixj
可乘之隙	kivx
空谷足音	kgzy
旷古未闻	kgww
坑杀	kgua
开弓不放箭	kgbj
看风使舵	kfud
开发区	kfou
狂风恶浪	kfel
开走	kdzz
开在	kdzd
开眼	kdyj
开战	kdvj
看电视	kdui
开锁	kdso
开年	kdnm
开列	kdlp
开练	kdlm
开卡	kdka
苦大仇深	kdiu
开吃	kdii
苦丁茶	kdia
开合	kdge
开单	kddj
开刀	kddc
开打	kdda
看得懂	kdds
开错	kdco
开标	kdbn
靠枕	kcvf
口不择言	kbvy
抗不住	kbvu
看不顺眼	kbuy
可不是吗	kbum
看不上	kbuh
恐怖分子	kbfz
立足未稳	lzww
楼市	lzui
来踪去迹	lzqj
漏光	lzgl
林子大了，什么鸟都有	lzdy
另做打算	lzds
燎原之势	lyvu
洛阳纸贵	lyvg
另有所指	lysv
里约热内卢	lyrl
另有企图	lyqt
两眼泪汪汪	lylw
利用率	lylv
聊一聊	lyln
练一练	lylm
另眼看待	lykd
利用价值	lyjv
烈焰红唇	lyhi
轮毂	lygu
六月飞雪	lyfx
轮渡	lydu
留言簿	lybo
旅行社	lhue
理性认识	lxru
联系联系	ljlj
劳心劳力	lxll
留下来	lxld
老乡见老乡	lxjx
冷笑话	lxhx
冷血动物	lxdw
联系电话	ljdh
略显不足	lxbz
遛弯儿	lwer
滤网	lvwh
连轴转	lvvr
两只手	lvuz
临阵退缩	lvts
来者可追	lvkd
来者不善，善者不来	lvbl
老神在在	luzz
流水作业	luzy
来势汹汹	luxx
卤汁	luvi
露台	lutd
陆路	lqlu
老少皆知	lujv
绿水长流	luil
路虎	luhu
雷声大，雨点小	ludx
卤菜	lucd
六神不安	luba
路途遥远	ltyy
雷霆雨露	ltyl
犁庭扫穴	ltsx
愣头青	ltqk
楼堂馆所	ltgs
聊天打屁	ltdp
两头不是人	ltbr
两头不讨好	ltbh
理所应当	lsyd
陇西	lsxi
绿色植物	lsvw
牢骚满腹	lsmf
临死拉个垫背的	lsld
拉三扯四	lsis
绿色环保	lshb
两三个月	lsgy
令人咋舌	lrvu
令人意外	lryw
令人遐想	lrxx
令人向往	lrxw
令人心痛	lrxt
令人瞩目	lrvm
令人振奋	lrvf
令人深思	lrus
令人痛心	lrtx
令人头疼	lrtt
礼让三分	lrsf
令人喷饭	lrpf
令人难忘	lrnw
令人难堪	lrnk
令人难过	lrng
令人惊喜	lrjx
令人惊叹	lrjt
令人敬佩	lrjp
令人叫绝	lrjj
令人激动	lrjd
令人骄傲	lrja
令人齿冷	lril
令人怀疑	lrhn
令人回味	lrhw
令人害怕	lrhp
令人高兴	lrgx
令人鼓舞	lrgw
令人感慨	lrgk
令人尴尬	lrgg
令人感动	lrgd
令人愤慨	lrfk
令人反感	lrfg
令人扼腕	lrew
令人担忧	lrdy
令人担心	lrdx
烈日当空	lrdk
老弱残兵	lrcb
令人不满	lrbm
令人不快	lrbk
令人不解	lrbj
令人不齿	lrbi
令人不安	lrba
令人安慰	lraw
六七月份	lqyf
留宿	lqsu
来去如风	lqrf
郎情妾意	lqqy
留情	lqqk
六七年	lqnm
两栖动物	lqdw
留点	lqdm
列宁	lpnk
列明	lpmk
零配件	lpjm
裸婚	lohy
罗锅	logo
老牛破车	lnpi
临难不惧	lnbj
连坐	lmzo
绿帽子	lmzi
恋战	lmvj
冷眉冷眼	lmly
狸猫换太子	lmhz
连个	lmge
两座	llzo
老来这一套	llvt
朗朗上口	lluk
零零碎碎	llss
来来去去	llqq
粮荒	llhl
联络函	llhj
两栋	llds
良多	lldo
亮点	lldm
两笔	llbi
搂搂抱抱	llbb
冷酷无情	lkmq
零上	lkuh
领路	lklu
利己主义	ljvy
临界状态	ljvt
恋奸情热	ljqr
理解力	ljli
老将出马，一个顶俩	ljil
蜡炬成灰泪始干	ljig
揽活	ljho
拉家带口	ljdk
路经此地	ljcd
谅解备忘录	ljbl
例行	lihh
凌迟处死	liis
利齿	liii
梨花	lihx
脸朝黄土背朝天	liht
来处不易	liby
离愁别恨	libh
利害相关	lhxg
兰花指	lhvi
零花钱	lhqm
老虎屁股摸不得	lhpd
厉害了	lhle
铝合金	lgjb
厉害吧	lhba
略高一筹	lgyi
锣鼓喧天	lgxt
愣住	lgvu
愣是	lgui
两国交兵，不斩来使	lgju
冷噤	lgjb
两国交兵	lgjb
两个黄鹂鸣翠柳	lghl
龙肝凤髓	lgfs
两个半	lgbj
楞逼	lgbi
老而不死是为贼	lebz
两耳不闻窗外事	lebu
老而不死	lebs
老掉牙了	ldyl
来袭	ldxi
来得容易去得快	ldrk
懒得理你	ldln
累得半死	ldbs
捞取	lcqu
老妹	lcmw
量才录用	lcly
老姐	lcjp
老花	lchx
老哥	lcge
老豆	lcdz
了此残生	lccu
淋雨	lbyu
临沂	lbyi
遴选	lbxr
邻县	lbxm
狼狈万状	lbmv
两把刷子	lbuz
理不清	lbqk
劣币驱逐良币	lbqb
萝卜青菜，各有所爱	lbqa
屡败屡战	lblv
冷不冷	lblg
临空	lbks
离不开	lbkd
零部件	lbjm
拉帮结伙	lbjh
冷不防	lbfh
林地	lbde
轮不到	lbdc
聊表寸心	lbcx
两鬓斑白	lbbb
拉直	lavi
拉丝	lasi
拉杆	lagj
弄不清	lbqk
弄不懂	lbds
满嘴跑火车	mzpi
灭自己威风	mzjf
麻衣神相	myux
名誉扫地	mysd
妙语如珠	myrv
鸣冤叫屈	myjq
名言警句	myjg
梦一场	myih
眯一会儿	myhe
命运多舛	mydi
面有菜色	mycs
绵延不断	mybd
木秀于林，风必摧之	mxyv
密西西比	mxxb
梅雨	mwyu
没问题了	mwtl
毛主席	mvxi
明知山有虎，偏向虎山行	mvuh
摸着石头过河	mvdh
忙这忙那	mvmn
民主党	mvdh
明知不可为而为之	mvbv
谋事在人，成事在天	muzt
面上无光	mumg
没事找事	muvu
妙手空空	mukk
幕府	mufu
闷声发大财	mufc
眉头一皱	mtyv
没听清	mtqk
门庭冷落	mtll
迷途羔羊	mtgy
木头疙瘩	mtgd
埋三怨四	msys
忙死了	msle
盲人瞎马	mrxm
美人儿	mrer
茫然不解	mrbj
麻雀虽小，五脏俱全	mqsq
满腔热血	mqrx
忙前忙后	mqmh
磨破	mopo
磨具	moju
漠北	mobw
美女如云	mnry
毛毛躁躁	mmzz
名门世家	mmuj
买买买	mmmd
灭门绝户	mmjh
默默耕耘	mmgy
默默奉献	mmfx
没老没少	mlmu
没脸没皮	mlmp
马六甲海峡	mljx
明令禁止	mljv
母老虎	mlhu
明来暗往	mlaw
名将	mkjl
命长	mkih
命大	mkda
满地	mjde
米线	mixm
迷瞪	midg
密闭	mibi
忙完	mhwj
明火执仗	mhvv
忙死	mhsi
梅花鹿	mhlu
眯会儿	mher
盟友	mgyz
目光如炬	mgrj
没反应过来	mfyl
门墙	mfql
马放南山	mfnu
满腹牢骚	mfls
门框	mfkl
命赴黄泉	mfhq
闷棍	mfgy
墨尔本	mebf
买账	mdvh
埋汰	mdtd
迈入	mdru
麦苗	mdmn
卖萌	mdmg
迈出	mdiu
命大福大	mdfd
买点	mddm
毛肚	mcdu
毛糙	mccc
民乐	mblc
木本植物	mbvw
名不正言不顺	mbvu
漫步其中	mbjv
明白了	mble
末班车	mbie
面不改色心不跳	mbgt
摸不到头绪	mbdx
门不当户不对	mbdd
马贼	mazw
码字	mazi
马奶	mand
骂名	mamk
万语千言	myqy
无遮无拦	mvml
万丈深渊	mvuy
万众期待	mvjd
无章可循	mvkx
万兽之王	muvw
无糖	moth
万水千山	muqu
无重	mois
万事亨通	muht
万事不求人	mubr
无商不奸	mubj
无土栽培	mtzp
无头苍蝇	mtcy
万死一生	msyu
无所忌惮	msjd
无人驾驶	mrju
无人机	mrji
无肉不欢	mrbh
万全之计	mqvj
无名英雄	mmyx
万里之遥	mlvy
无路可退	mlkt
无理搅三分	mljf
无利不起早	mlbz
无可取代	mkqd
无可讳言	mkhy
无可非议	mkfy
万年	monm
无迹可寻	mjkx
无处安身	miau
万壑争流	mhvl
无话不说	mhbu
无规矩不成方圆	mgjy
万法归宗	mfgz
无从知晓	mcvx
无补于事	mbyu
宁做鸡头不做凤尾	nzjw
宁有种乎	nyih
那一套	nytc
哪一天	nytm
哪一款	nykr
哪一回	nyhv
哪一次	nyci
逆向思维	nxsw
内框	nwkl
内角	nwjn
捏着一把汗	nvyh
难者不会	nvbh
年少有为	nuyw
年深日久	nurj
逆天改命	ntgm
农用	nsys
农闲	nsxm
农庄	nsvl
农舍	nsue
农奴	nsnu
农贸	nsmc
农垦	nskf
农户	nshu
农耕	nsgg
暖胃	nrww
拿人家的手软	nrjr
暖床	nril
扭力	nqli
扭矩	nqju
牛叉	nqia
能掐会算	nqhs
南拳北腿	nqbt
宁缺不滥	nqbl
啮合	npge
诺诺	nono
腻腻歪歪	nnww
尿片	nnpm
黏黏糊糊	nnhh
脑膜炎	nmyj
年尾	nmww
农贸市场	nmui
年节	nmjp
浓眉大眼	nmdy
捏了一把汗	nlyh
能力所及	nlsj
拿了鸡毛当令箭	nljj
宁日	nkri
男神	njuf
年纪轻轻	njqq
难堪	njkj
南疆	najl
那句话	nghx
哪几个	njge
南段	nadr
能见度	njdo
难捱	nj
逆子	nizi
霓裳羽衣	niyy
农产品	nipb
霓裳	niih
怒火万丈	nhmv
囔囔	nhnh
年过三十	ngse
尼古丁	ngdk
尼姑庵	ngan
农副产品	nfip
嫩滑	nfhx
拿得起放得下	ndqx
奶瓶	ndpk
脑袋瓜子	ndgz
脑袋瓜	ndgx
脑梗	ncgg
难辨真伪	nbvw
拿不定主意	nbdy
哪像	naxl
拿铁	natp
纳凉	nall
那届	najp
那般	nabj
辗转难眠	nvnm
疑难重症	nniv
偶一为之	oywv
偶一	ouyi
区域化	oyhx
区块	oukk
拚	pbfc
拚	pjfc
萍踪浪迹	pzlj
拼音字母	pyzm
拼音文字	pywz
偏向于	pxyu
咆哮如雷	pxrl
旁系亲属	pjqu
平心静气	pxjq
培训班	pxbj
赔笑	pwxn
抛物线	pwxm
片瓦无存	pwmc
配饰	pwui
培根	pwgf
偏重于	piyu
披着羊皮的狼	pvyl
片纸只字	pvvz
破竹之势	pvvu
旁枝末节	pvmj
攀枝花	pvhx
皮之不存，毛将焉附	pvbf
普贤	puxm
莆田	putm
屁事没有	pumy
噗嗤	puii
平头正脸	ptvl
评头品足	ptpz
偏听偏信	ptpx
扑通扑通	ptpt
葡萄酒	ptjq
爬起来	pqld
平平仄仄	ppzz
撇撇嘴	ppzv
碰碰运气	ppyq
平平稳稳	ppww
平平整整	ppvv
批评指正	ppvv
朴朴实实	ppuu
漂漂亮亮	ppll
仆仆风尘	ppfi
蓬蓬勃勃	ppbb
颇能	pong
颇费	pofw
破洞	pods
飘雨	pnyu
票证	pnvg
跑哪去了	pnql
偏下	pmxx
偏小	pmxn
偏上	pmuh
偏少	pmuc
偏弱	pmro
偏强	pmjl
贫民窟	pmku
片场	pmih
偏好	pmhc
破门而出	pmei
匹马单枪	pmdq
偏低	pmdi
偏不	pmbu
盆满钵满	pmbm
蒲柳之姿	plvz
普罗大众	pldv
平顺	pkuy
怕苦怕累	pkpl
破口大骂	pkdm
破家县令	pjxl
平均主义	pjvy
攀折	pjue
蟠桃	pjtc
攀爬	pjpa
盘后	pjhz
片甲不存	pjbc
批语	piyu
排除异己	piyj
泼出去的水	piqu
骗吃骗喝	piph
派出机构	pijg
疲乏	pifa
皮草	picc
胖瘦	phuz
胖妞	phnq
匹夫有责	pfyz
喷绘	pfhv
牌桌	pdvo
牌照	pdvc
抛到脑后	pdnh
平地风波	pdfb
屁大点事	pddu
皮糙肉厚	pcrh
骗财骗色	pcps
泡茶	pcia
跑调	pcdn
配不上	pbuh
蓬勃发展	pbfv
漂白粉	pbff
扑鼻而来	pbel
平板电脑	pbdn
拼单	pbdj
跑不掉	pbdn
怕累	palw
怕苦	paku
蜷作一团	qzyt
轻言细语	qyxy
青眼相加	qyxj
秋月春风	qyif
气息奄奄	qxyy
趋向于	qxyu
缺心眼儿	qxye
缺心少肺	qxuf
趣味相投	qwxt
趣味性	qwxk
权威性	qwxk
七歪八扭	qwbn
前阵子	qvzi
旗帜鲜明	qvxm
曲折蜿蜒	quwy
缺肢少腿	qvut
牵着鼻子走	qvbz
企事业	quye
曲直	quvi
屈身	quuf
屈伸	quuf
潜水艇	qutk
曲牌	qupd
切实可行	qukh
躯壳	quke
亲上加亲	qujq
亲身经历	qujl
取货	quho
穷山恶水出刁民	quem
七十二行	qeeh
秋收冬藏	qudc
屈才	qucd
青山不改	qubg
求神拜佛	qubf
缺水	qtuv
却能	qtng
全天候	qthz
轻松写意	qsxy
前人栽树，后人乘凉	qrzl
全责	qrze
泉州	qrvz
亲如手足	qruz
全市	qrui
全套	qrtc
全日	qrri
全清	qrqk
全篇	qrpm
全款	qrkr
全看	qrkj
全靠	qrkc
全程	qrig
亲如骨肉	qrgr
全班	qrbj
千秋万载	qqmz
千秋万岁	qqms
切切实实	qquu
亲亲热热	qqrr
亲戚朋友	qqpy
七窍流血	qqlx
囚牢	qqlc
秋葵	qqkv
谦谦君子	qqjz
茕茕孑立	qqjl
权倾朝野	qqiy
全球化	qqhx
齐齐哈尔	qqhe
群情鼎沸	qqdf
切切	qpqp
切莫	qpmo
切腹	qpfu
七平八稳	qpbw
千难万阻	qnmz
千难万难	qnmn
轻拿轻放	qnqf
巧了	qnle
桥段	qndr
阡陌纵横	qmzh
敲门砖	qmvr
前山	qmuj
签批	qmpi
青面獠牙	qmly
青睐有加	qlyj
千里眼	qlyj
千里同风	qltf
巧立名目	qlmm
墙里开花墙外香	qlkx
秋老虎	qlhu
曲里拐弯	qlgw
曲里拐弯儿	qlge
千里鹅毛	qlem
七零八碎	qlbs
千里不同风	qlbf
青烟	qkyj
情谊	qkyi
倾销	qkxn
顷刻之间	qkvj
青山	qkuj
情商	qkuh
清退	qktv
清汤	qkth
青梅	qkmw
清流	qklq
清零	qklk
青椒	qkjn
青瓜	qkgx
轻轨	qkgv
情妇	qkfu
情分	qkff
千金一掷	qjyv
千军易得	qjyd
齐集于此	qjyc
千金之子，坐不垂堂	qjvt
前几日	qjri
清洁剂	qjji
勤俭持家	qjij
穷家富路	qjfl
契约	qiyc
欺压	qiya
七旬	qixy
栖息	qixi
歧途	qitu
砌墙	qiql
七尺男儿	qine
气冲牛斗	qind
旗舰	qijm
气冲冲	qiis
气话	qihx
企划	qihx
岂会	qihv
起锅	qigo
妻儿	qier
汽灯	qidg
秦皇汉武	qhhw
穷根究底	qgjd
气鼓鼓	qggu
缺胳膊少腿	qgbt
秋风萧瑟	qfxs
气愤填膺	qfty
凄风冷雨	qfly
秋风过耳	qfge
棋逢对手，将遇良才	qfdc
气定神闲	qdux
千岛湖	qdhu
青灯黄卷	qdhj
青灯古佛	qdgf
气度不凡	qdbf
七八月份	qbyf
七八年	qbnm
拳不离手	qblu
去不了	qble
曲不离口	qblk
起不来	qbld
千杯不醉	qbbz
前半部分	qbbf
纤体	qmti
肉馅	rzxm
柔性	rzxk
人在屋檐下	rzwx
人在屋檐下，不得不低头	rzwt
肉排	rzpd
人要衣装	ryyv
日益突出	ryti
日有所思，夜有所梦	rysm
仁义礼智信	rylx
人心险恶	rxxe
人心齐泰山移	rxqy
人心涣散	rxhs
人无远虑	rmyl
人往高处走，水往低处流	rwgl
人文关怀	rwgh
人为刀俎，我为鱼肉	rwdr
人之将死，其言也善	rvju
人身自由	ruzy
日升月恒	ruyh
入学	ruxt
入市	ruui
人是铁饭是钢	rutg
如诗如画	rurh
人寿年丰	runf
入坑	rukg
人生苦短	rukd
人社局	ruju
肉食动物	rsdw
人生不如意事十之八九	rubj
人体工程	rtgi
人死如灯灭	rsrm
容让	rsrh
荣光	rsgl
人人为我，我为人人	rrwr
忍辱求全	rrqq
人若犯我，我必犯人	rrfr
任人摆布	rrbb
人强马壮	rjmv
任凭风浪起	rpfq
弱碱	rojm
戎马生涯	rmuy
人模人样	rmry
如梦如幻	rmrh
人民群众	rmqv
热空气	rkqi
人间烟火	rjyh
日进万金	rjmj
日进千金	rjqj
日久年深	rjnu
日常用语	riyy
日结	rijp
如花似锦	rhsj
如花美眷	rhmj
热锅里的蚂蚁	rgly
人过留名，雁过留声	rglu
仍可	rgke
人脉	rfmd
认路	rflu
认了	rfle
忍了	rfle
热饮	reyb
人淡如菊	rdrj
人多好干活	rdhh
人大代表	rddb
肉嘟嘟	rddu
绕圈	rcjr
人不像人	rbxr
日不暇给	rbxg
人不为己，天诛地灭	rbwm
容不容易	rbry
让不让人	rbrr
让不让	rbrh
人不人鬼不鬼	rbrg
热不热	rbre
人比花娇	rbhj
人不犯我	rbfw
人不犯我，我不犯人	rbfr
三灾八难	szbn
岁月无情	symq
所有制	syvi
岁月如梭	syrs
岁月荏苒	syrr
死要面子	symz
岁月蹉跎	syct
三月不知肉味	sybw
虽远必诛	sybv
森严壁垒	sybl
四下无人	sxmr
思乡情切	sxqq
三心两意	sxly
思想家	sxjx
思想境界	sxjj
四星级	sxji
三星级	sxji
三文鱼	swyu
四五月份	swyf
塞翁失马，安知非福	swuf
四五天	swtm
三五天	swtm
三五年	swnm
四五年	swnm
思维模式	swmu
酸文假醋	swjc
四五个月	swgy
绥靖	svjk
四肢发达	svfd
私生子	suzi
夙愿	suyr
诉状	suvl
三十年河西	senx
私生女	sunv
三十年河东	send
三十年	senm
似水流年	suln
素爱	suai
扫榻以待	styd
缩头乌龟	stwg
三天三夜说不完	stsw
酸甜苦辣咸	stkx
酸甜可口	stkk
三堂会审	sthu
三四月份	ssyf
三岁小孩都知道	ssxd
斯斯文文	ssww
送往	sswh
松鼠	ssuu
三四天	sstm
所思所想	sssx
松松	ssss
送入	ssru
松茸	ssrs
三四年	ssnm
送礼	ssli
三四个月	ssgy
随俗浮沉	ssfi
酸爽	srul
酸楚	sriu
蒜瓣	srbj
损人不利己	srbj
俗气得很	sqdh
缩窄	sovd
随你的便	sndb
三年不鸣	snbm
随你吧	snba
四面开花	smkh
森罗万象	slmx
僧来看佛面	slkm
酸了吧唧	slbj
松口气	skqi
散席	sjxi
散散	sjsj
散客	sjke
私家车	sjie
散光	sjgl
四季分明	sjfm
三餐	sjcj
三层	sjcg
私家菜	sjcd
私信	sixb
私情	siqk
死期	siji
私密	simi
撕烂	silj
三岔路	silu
死叉	siia
丝滑	sihx
厮打	sida
四处奔走	sibz
三好学生	shxu
桑葚	shuf
岁寒三友	shsy
丧魂落魄	shlp
死灰槁木	shgm
算个屁	sgpi
三更灯火五更鸡	sgdj
三个半	sgbj
三分天下	sftx
三方面	sfmm
四方八面	sfbm
色心	sexb
色衰	secv
酸儿辣女	seln
死而不僵	sebj
腮红	sdhs
色胆包天	sdbt
扫清	scqk
骚气	scqi
骚包	scbc
三步一岗，五步一哨	sbyu
三不沾	sbvj
随便你了	sbnl
算不了什么	sblm
酸不拉几	sblj
随便了	sble
思不出位	sbiw
食物中毒	swvd
食君之禄，忠君之事	sjvu
食不知味	sbvw
天作孽犹可恕	tznu
投资回报率	tzhl
天姿国色	tzgs
徒增烦恼	tzfn
兔子不吃窝边草	tzbc
退一万步	tymb
统一战线	tyvx
田园牧歌	tymg
同业公会	tygh
太阳从西边出来	tycl
袒胸露背	txlb
天文数字	twuz
台湾省	twug
天王老子	twlz
天王老子都不怕	twlp
退无可退	tmkt
体温计	twji
台湾岛	twdc
通知书	tvuu
同志仍需努力	tvrl
统治阶级	tvjj
头上三尺有神明	tusm
土司	tusi
图强	tujl
太上老君	tulj
秃鹫	tujq
挺适合	tuge
天时地利	tudl
徒弟	tudi
天上不会掉馅饼	tubb
滔天罪行	ttzh
天塌下来	ttxl
剃头挑子一头热	tttr
推推搡搡	ttss
淘汰赛	ttsd
头头脑脑	ttnn
滔天怒火	ttnh
甜甜蜜蜜	ttmm
滔滔江水	ttju
天塌地陷	ttdx
田头地里	ttdl
贪图安逸	ttay
吐丝自缚	tszf
通晓	tsxn
通配	tspw
同款	tskr
铜矿	tskl
通缉	tsji
童工	tsgs
挺容易	tryi
讨人喜欢	trxh
坦然面对	trmd
台前幕后	tqmh
贴纸	tpvi
铁青	tpqk
铁皮	tppi
铁管	tpgr
头皮发麻	tpfm
拖走	tozz
拖影	toyk
妥妥	toto
鸵鸟政策	tdvc
跳伞	tnsj
天南海北	tnhb
天性	tmxk
天梯	tmti
填列	tmlp
天劫	tmjp
填单	tmdj
他妈的	tmde
吐露心声	tlxu
天理昭昭	tlvv
太累了	tlle
拖了后腿	tlht
涕泪横流	tlhl
挺厉害	tlhd
桃李不言，下自成蹊	tlbq
螳螂捕蝉，黄雀在后	tlbh
挺严	tkyj
挺闲	tkxm
挺准	tkvy
挺住	tkvu
挺少	tkuc
挺俗	tksu
挺松	tkss
挺色	tkse
挺骚	tksc
挺全	tkqr
听清	tkqk
挺牛	tknq
挺烂	tklj
挺假	tkjx
挺长	tkih
挺差	tkci
挺怪	tkgk
摊销	tjxn
谈着	tjvc
跳进黄河洗不清	tjhq
退居二线	tjex
田间地头	tjdt
叹词	tjci
坦诚相见	tixj
体腔	tiql
踢开	tikd
退出江湖	tijh
梯度	tido
天差地别	tcdb
桃花运	thyy
挺好用	thys
铁汉柔情	thrq
糖浆	thjl
钛合金	tgjb
天高云淡	tgyd
铁骨铮铮	tgvv
替古人担忧	tgry
唐古拉山	tglu
太贵了	tgle
太过分	tgff
挺贵的	tgde
通风管	tfgr
挺方便	tfbm
特质	tevi
拖儿带女	tedn
添丁增口	tdzk
太脏	tdzh
天地玄黄	tdxh
天打五雷轰	tdwh
台柱	tdvu
太瘦	tduz
太轻	tdqk
偷得浮生半日闲	tdfx
太矮	tdai
天材地宝	tcdb
抬不起头	tbqt
听不清	tbqk
听不清楚	tbqi
听不出	tbiu
透不过气	tbgq
通不过	tbgo
拓印	tayb
踏青	taqk
手足相残	uzxc
收窄	uzvd
实在是高	uzug
胜造七级浮屠	uzqt
收纳	uzna
售楼	uzlz
收罗	uzlo
受理	uzli
收货	uzho
手粗	uzcu
手残	uzcj
身在曹营心在汉	uzch
顺子	uyzi
施以援手	uyyu
少一些	uyso
实用主义	uyvy
谁与争锋	uyvf
是药三分毒	uysd
授业解惑	uyjh
顺滑	uyhx
少言寡语	uygy
上下左右	uxzy
上行下达	uhxd
收效甚微	uxuw
身心俱疲	uxjp
耍猴	uxhz
刷单	uxdj
上下班	uxbj
双下巴	uxba
顺我者昌	uwvi
生物钟	uwvs
生无可恋	umkl
上午好	uwhc
识文断字	uwdz
水中	uvvs
上知天文	uvtw
上知天文，下知地理	uvtl
失之东隅，收之桑榆	uvdy
身正不怕影子斜	uvbx
肾上腺素	uuxs
伤势未愈	uuwy
竖条	uutn
暑热	uure
声声入耳	uure
神神秘秘	uubb
熟客	uuke
审时度势	uudu
鼠胆	uudj
试试吧	uuba
上吐下泻	utxx
上天入地	utrd
舍死忘生	uswu
授人以鱼，不如授人以渔	uryy
水软山温	uruw
涮涮	urur
生日快乐	urkl
霜染白发	urbf
失去了	uqle
说清楚	uqiu
耍贫嘴	upzv
水平如镜	uprj
商品流通	uplt
商品房	upfh
说点	uodm
审美疲劳	umpl
水漫金山	umju
睡眠不足	umbz
是骡子是马，拉出来溜溜	ulzl
生理卫生	ulwu
水利枢纽	ulun
双色	ulse
双栖	ulqi
水里来火里去	ullq
双开	ulkd
生力军	uljy
水利工程	ulgi
双份	ulff
山乡	ujxl
失节事大	ujud
善款	ujkr
善举	ujju
身居高位	ujgw
手脚并用	ujby
数见不鲜	ujbx
拾金不昧	ujbm
视野	uiye
施压	uiya
嗜血	uixp
试着	uivc
试水	uiuv
实数	uiuu
屎尿	uinn
师门	uimf
试管	uigr
拾掇	uido
抒怀言志	uhyv
上限	uhxm
社会制度	uhvd
说话算话	uhsh
耍花腔	uhql
售后服务	uhfw
说话带刺	uhdc
声誉	ugyu
上纲上线	ugux
生涩	ugse
时光荏苒	ugrr
剩女	ugnv
说个没完	ugmw
时乖命蹇	ugmj
伸个懒腰	ugly
省了	ugle
声控	ugks
升幅	ugfu
甚于	ufyu
审验	ufyj
身亡	ufwh
神龙	ufls
师傅领进门，修行靠个人	uflr
师傅领进门	uflm
说风凉话	uflh
伸长	ufih
是非黑白	ufhb
深耕	ufgg
申根	ufgf
顺风耳	ufer
尚方宝剑	ufbj
社群	ueqy
蛇皮	uepi
伤敌一千，自损八百	udyb
闪电战	udvj
蜀道难，难于上青天	udnt
势单力薄	udlb
树大根深	udgu
说得过去	udgq
守财奴	ucnu
殊不知	ubvi
手把手	ubuz
说不说	ubuo
说不明白	ubmb
社保局	ubju
说不好	ubhc
上兵伐谋	ubfm
舍不得孩子套不住狼	ubdl
上半辈子	ubbz
折弯	uewj
折寿	ueuz
止增笑耳	vzxe
捉贼捉赃	vzvz
皱褶	vzve
骤降	vzjl
睁一只眼，闭一只眼	vyvy
主要是	vyui
这一天	vytm
转一圈儿	vyje
这一块	vykk
状元及第	vyjd
止于唇齿	vyii
找一个	vyge
这样都行	vydh
桌椅板凳	vybd
只许州官放火，不许百姓点灯	vxvd
直辖市	vxui
直系亲属	vjqu
知行合一	vhgy
真心话	vxhx
植物纤维	vwqw
真伪难辨	vwnb
赚外快	vwkk
中午好	vwhc
治外法权	vwfq
站着说话不嫌腰疼	vvut
铮铮铁骨	vvtg
皱着眉头	vvmt
谆谆教导	vvjd
执政党	vvdh
皱皱巴巴	vvbb
直上云霄	vuyx
住院	vuyr
住下	vuxx
真实写照	vuxv
主推	vutv
志士仁人	vurr
筑牢	vulc
知识产权	vuiq
逐水而居	vuej
终身大事	vudu
纸上得来终觉浅	vudq
摘桃子	vtzi
猪头肉	vtrz
指条明路	vtml
真他妈的	vtmd
真他妈	vtma
震天动地	vtdd
中药	vsyc
忠孝	vsxn
中日	vsri
中号	vshc
中饭	vsfj
中俄	vsee
至死不变	vsbb
颛顼	vrxu
主人翁	vrwg
知人之明	vrvm
真人不露相	vrbx
终日奔波	vrbb
真情实意	vquy
准确率	vqlv
中秋快乐	vqkl
正前方	vqfh
知情不举	vqbj
着笔	vcbi
中年人	vnrf
捉拿归案	vnga
正面人物	vmrw
专门利人	vmlr
这么简单	vmjd
直眉瞪眼	vmdy
转来转去	vlvq
蒸馏水	vluv
着凉了	vlle
竹篮打水一场空	vldk
真可谓是	vkwu
中看不中用	vkby
站桩	vjvl
浙江省	vjug
斩将搴旗	vjqq
知己难求	vjnq
张家界	vjjp
战功	vjgs
战队	vjdv
针尖对麦芒	vjdm
忠君爱国	vjag
指责	vize
支援	viyr
直营	viyk
枝丫	viya
转嗔为喜	viwx
指示	viui
之上	viuh
致死	visi
主持人	virf
智力	vili
智库	viku
直降	vijl
致敬	vijk
纸巾	vijb
制动	vids
纸杯	vibw
掌纹	vhwf
这话说的	vhud
征信	vgxb
整晚	vgwj
蒸煮	vgvu
正忙	vgmh
整列	vglp
征程	vgig
整行	vghh
正方	vgfh
枕戈待旦	vgdd
中关村	vgcy
照方子抓药	vfzy
真脏	vfzh
真元	vfyr
正方形	vfxk
指腹为婚	vfwh
真难	vfnj
真乱	vflr
真丑	vfiz
针管	vfgr
知法犯法	vfff
这项	vexl
褶皱	vevz
哲理	veli
这届	vejp
丈二金刚	vejg
赚点外快	vdwk
真刀真枪	vdvq
战斗机	vdji
真的假的	vdjd
捉刀代笔	vddb
找虐	vcnt
招财进宝	vcjb
找遍	vcbm
站不住脚	vbvj
直布罗陀海峡	vblx
直布罗陀	vblt
准备了	vble
睁不开眼	vbky
真不愧是	vbku
真不错	vbco
炸窝	vawo
择人而噬	vreu
咋不早说	vbzu
咋不知道	vbvd
咋不	vabu
妄自揣测	wzic
问一下	wyxx
五洋捉鳖	wyvb
物有所值	wysv
玩于股掌之上	wygu
汪洋大海	wydh
晚一步	wybu
温馨甜蜜	wxtm
五星级	wxji
尾页	wwye
威压	wwya
畏畏缩缩	wwss
为期	wwji
娃娃脸	wwlm
玩完了	wwle
文文静静	wwjj
微创	wwil
微薄	wwbc
玩着玩着	wvwv
物质文明	wvwm
尾椎骨	wigu
误中副车	wvfi
诬陷	wuxm
污水	wuuv
望山跑死马	wupm
五年	wunm
忤逆	wuni
为山九仞	wujr
误触	wuiu
文山会海	wuhh
晚上好	wuhc
委托书	wtuu
勿谈国事	wtgu
我所欲也	wsyy
王孙公子	wsgz
往日无怨	wrmy
为人正直	wrvv
温润如玉	wrry
温柔敦厚	wrdh
剜肉补疮	wrbi
巍然不动	wrbd
五禽戏	wqxi
雾气腾腾	wqtt
乌漆墨黑	wqmh
威迫利诱	wply
卧槽	wocc
窝边	wobm
玩弄于鼓掌之中	wlyv
问牛答马	wndm
雾蒙蒙	wmmg
五六月份	wlyf
物联网	wlwh
玩两天	wltm
五六年	wlnm
外来和尚好念经	wlhj
五六个月	wlgy
武林高手	wlgu
温良恭俭让	wlgr
温良恭俭	wlgj
挽狂澜于既倒	wkld
挽住	wjvu
挽着	wjvc
晚睡	wjuv
玩票	wjpn
危机重重	wjii
外交关系	wjgj
五角大楼	wjdl
外交辞令	wjcl
晚辈	wjbw
晚报	wjbc
物超所值	wisv
外弛内张	winv
完成了	wile
我还以为	whyw
问寒问暖	whwn
网文	whwf
网名	whmk
维和部队	whbd
亡国之音	wgvy
温哥华	wghx
五分钟	wfvs
文殊	wfuu
威风扫地	wfsd
闻风而起	wfeq
稳定性	wdxk
外伤	wduh
五短身材	wduc
完蛋了	wdle
外框	wdkl
外接	wdjp
误操作	wczo
五彩纷呈	wcfi
玩不玩	wbwj
我不犯人	wbfr
仙姿玉貌	xzym
小姨子	xyzi
稀有元素	xyys
巡夜	xyye
讯息	xyxi
献言献策	xyxc
侠以武犯禁	xywj
享有盛誉	xyiy
协议书	xyuu
吸引人	xyrf
殉情	xyqk
悬崖峭壁	xyqb
鲜衣怒马	xynm
悬崖勒马	xylm
稀有金属	xyju
虚应故事	xygu
硝烟滚滚	xygg
幸运儿	xyer
兄友弟恭	xydg
学艺不精	xybj
下限	xxxm
心胸狭隘	xxxa
相形失色	xxus
形象思维	xxsw
先小人后君子	xxrz
小小年纪	xxnj
小心没大错	xxmc
修行靠个人	xhkr
下滑	xxhx
下锅	xxgo
絮絮叨叨	xxdd
想想办法	xxbf
修修补补	xxbb
心外无物	xwmw
下午好	xwhc
闲着也是闲着	xvyv
心中有鬼	xvyg
心中无数	xvmu
修正主义	xvvy
闲着没事干	xvmg
新账老账一起算	xvls
下知地理	xvdl
小叔子	xuzi
新生事物	xuuw
叙事	xuui
小试牛刀	xund
小市民	xumb
信守承诺	xuin
心事重重	xuii
心神恍惚	xuhh
形势比人强	xubj
心神不宁	xubn
相谈甚欢	xtuh
乡土气息	xtqx
熊熊	xsxs
心素如简	xsrj
胸闷	xsmf
相似度	xsdo
血肉之躯	xrvq
小人之见	xrvj
笑容满面	xrmm
血肉模糊	xrmh
炫酷	xrku
形容枯槁	xrkg
选重	xris
选股	xrgu
旭日东升	xrdu
选单	xrdj
虚弱不堪	xrbk
徇情枉法	xqwf
香气扑鼻	xqpb
效犬马之劳	xqml
想清楚	xqiu
修桥补路	xqbl
小朋友	xpyz
香飘十里	xpel
写满	xpmj
下坡路	xplu
协警	xpjk
血盆大口	xpdk
喜怒不形于色	xnbs
咸鱼	xmyu
蓄谋已久	xmyj
小拇指	xmvi
显露	xmlu
羡慕嫉妒恨	xmjh
县城	xmig
笑脸相迎	xlxy
相通	xlts
雪里送炭	xlst
相思	xlsd
相若	xlro
向来如此	xlrc
响铃	xllk
心灵鸡汤	xljt
血流成河	xlih
想成	xlig
香瓜	xlgx
绚丽多姿	xldz
香醋	xlcu
刑讯	xkxy
许可证	xkvg
醒脑	xknc
性命	xkmk
相看两不厌	xkly
休克疗法	xklf
刑拘	xkgz
新纪元	xjyr
心肌梗塞	xjgs
相差无几	xcmj
西施	xiui
戏曲	xiqu
心潮起伏	xiqf
嘻哈	xiha
西段	xidr
小惩大诫	xidj
新华社	xhue
喜欢吗	xhma
学会了	xhle
新婚快乐	xhkl
鲜花插在牛粪上	xhiu
血光之灾	xgvz
习惯上	xguh
先公后私	xghs
小高层	xgcg
响鼓不需重锤	xgbi
心肝宝贝	xgbb
媳妇儿	xfer
秀而不实	xebu
相当有一套	xdyt
心地善良	xdul
相对湿度	xdud
想到哪说到哪	xdnn
学到老	xdlc
闲得慌	xdhl
喜得贵子	xdgz
小地方	xdfh
羞答答	xdda
秀才造反，三年不成	xczi
秀才遇到兵，有理说不清	xcyq
秀才遇到兵	xcyb
心存善念	xcun
小聪明	xcmk
心存敬畏	xcjw
秀才不出门	xcbm
心智	xbvi
心说	xbuo
想不明白	xbmb
小本经营	xbjy
下笔成章	xbiv
心寒	xbhj
下半辈子	xbbz
香饽饽	xbbo
越走越远	yzyy
优选	yzxr
有嘴无心	yzmx
优渥	yzwo
油水	yzuv
由头	yztz
远在天边，近在眼前	yztq
友邻	yzlb
一字长蛇阵	yziv
扬子鳄	yzee
有孕在身	yyzu
犹犹豫豫	yyyy
炎炎夏日	yyxr
优越性	yyxk
有缘无分	yymf
饮用水	yyuv
悠悠岁月	yysy
一夜情	yyqk
阴雨绵绵	yymm
烟雨蒙蒙	yymm
鱼跃龙门	yylm
阴雨连绵	yylm
庸庸碌碌	yyll
有一利必有一弊	yylb
狺狺狂吠	yykf
异于常人	yyir
晕晕乎乎	yyhh
音乐会	ylhv
一一过问	yygw
一拥而入	yyer
营养不良	yybl
有冤报冤，有仇报仇	yybi
一言不合	yybg
欲仙欲死	yxys
亚细亚	yxya
一心只读圣贤书	yxvu
游戏人间	yxrj
以小人之心，度君子之腹	yxrf
野性难驯	yxnx
英雄难过美人关	yxng
英雄豪杰	yxhj
鱼腥草	yxcc
忧喜参半	yxcb
一心不能二用	yxby
一误再误	ywzw
余味无穷	ywmq
与我无关	ywmg
洋为中用	ywvy
有问题	ywti
一无所能	ymsn
圆舞曲	ywqu
义务教育	ywjy
一直以来	yvyl
以至于	yvyu
以壮行色	yvhs
有志者事竟成	yvvi
言之尚早	yvuz
言志抒怀	yvuh
硬着头皮上	yvtu
一朝权在手，便把令来行	yiqh
有章可循	yvkx
宇宙洪荒	yvhh
一展风采	yvfc
一盏灯	yvdg
义正辞严	yvcy
亦师亦友	yuyy
有说有笑	yuyx
远胜于我	yuyw
寓意	yuyi
一时无两	yuml
鱼水之欢	yuvh
养生之道	yuvd
以示清白	yuqb
有失偏颇	yupp
一声令下	yulx
一尸两命	yulm
一身冷汗	yulh
应试教育	yujy
一手交钱	yujq
一手交货	yujh
右上角	yujn
严师出高徒	yuit
预产	yuij
玉成	yuig
引蛇出洞	yuid
于是乎	yuhu
有伤风化	yufh
移山倒海	yudh
依山傍水	yubu
一声不吭	yubh
有头有脸	ytyl
越小	ytxn
一团漆黑	ytqh
有头没脑	ytmn
一天两天	ytlt
一条路跑到黑	ytlh
一探究竟	ytjj
仰天长啸	ytix
油头滑脑	ythn
仰天大笑	ytdx
一条道跑到黑	ytdh
越大	ytda
摇头摆尾	ytbw
一通百通	ytbt
意思一下	ysyx
阴森森	yssf
一死了之	yslv
用回	yshv
有所不知	ysbv
一死百了	ysbl
嫣然一笑	yryx
以势压人	yuyr
音容笑貌	yrxm
原委	yrww
与人无争	yrmv
阅人无数	yrmu
冤枉	yrwh
一日为师，终生为父	yrwf
有如神助	yruv
引人深思	yrus
原生	yrug
远看	yrkj
与日俱增	yrjz
圆角	yrjn
一人吃饱，全家不饿	yrie
原话	yrhx
圆管	yrgr
用人不疑，疑人不用	yrby
一日不见如隔三秋	yrbq
一日不见	yrbj
远比	yrbi
阴晴圆缺	yqyq
有求于你	yqyn
以其人之道，还治其人之身	yjru
欲穷千里目，更上一层楼	yqql
有气没力	yqml
欲求不满	yqbm
有凭有据	ypyj
一片汪洋	ypwy
一片生机	ypuj
一片坦途	yptt
一片片	yppm
一票难求	ypnq
有屁快放	ypkf
一片焦土	ypjt
有屁就放	ypjf
一屁股债	ypgv
一片光明	ypgm
眼皮底下	ypdx
一片冰心在玉壶	ypbh
以你为荣	ynwr
有奶便是娘	ynbn
夜猫子进宅，无事不来	ymzl
有模有样	ymyy
英明一世	ymyu
圆明园	ymyr
一脉相通	ymxt
一脉相承	ymxi
一面之缘	ymvy
仰慕之情	ymvq
一码事	ymui
虞美人	ymrf
榆木脑袋	ymnd
一抹亮色	ymls
眼冒金星	ymjx
夜幕降临	ymjl
榆木疙瘩	ymgd
有来有往	ylyw
有零有整	ylyv
一冷一热	ylyr
越来越难	ylyn
娱乐娱乐	ylyl
又累又困	ylyk
有理有据	ylyj
越来越差	ylyc
又冷又饿	ylye
娱乐性	ylxk
一力降十会	yljh
有理说不清	yluq
原来是	ylui
一粒老鼠屎，坏了一锅粥	yllv
一粒老鼠屎	yllu
雨露均沾	yljv
一两个月	ylgy
一鳞半爪	ylbv
有理不在声高	ylbg
鹰爪	ykvc
一块石头落了地	ykdd
云开日出	ykri
盈缺	ykqt
一块钱	ykqm
一刻千金	ykqj
有口难分	yknf
有口难辩	yknb
一颗老鼠屎，坏了一锅粥	yklv
一颗老鼠屎	yklu
又惊又喜	yjyx
有借有还，再借不难	yjyn
以儆效尤	yjxy
英俊潇洒	yjxs
有教无类	yjml
眼熟	yjuu
眼疾手快	yjuk
永结同心	yjtx
研究所	yjso
一己私利	yjsl
一家人不说两家话	yjrh
一将难求	yjnq
严苛	yjke
月经不调	yjbd
越扯越远	yiyy
又臭又硬	yiyy
一唱一和	yiyh
意淫	yiyb
依循	yixy
意向	yixl
寅吃卯粮	yiml
阴沉沉	yiif
言出法随	yifs
一触而发	yief
颐和园	yhyr
养颜	yhyj
月黑杀人夜	yhuy
月黑杀人	yhur
有话快说	yhku
一会就好	yhjh
羽化成仙	yhix
一哄而起	yheq
羽化登仙	yhdx
一行白鹭上青天	yhbt
油光锃亮	ygzl
鱼肝油	ygyz
于公于私	ygys
一个愿打，一个愿挨	ygya
因果循环	ygxh
阳刚之气	ygvq
应该说是	yguu
掩过饰非	yguf
邀功请赏	ygqu
一个梦	ygmg
一个来回	yglh
眼观六路，耳听八方	yglf
一个礼拜	yglb
一个唱红脸，一个唱白脸	ygil
一公分	ygff
应该的	ygde
阳光灿烂	ygcl
一个半	ygbj
鸢飞鱼跃	yfyy
有福同享，有难同当	yftd
有负所托	yfst
一番口舌	yfku
预付款	yfkr
一分价钱一分货	yfjh
幺蛾子	yezi
一二月份	yeyf
业障	yevh
有胆有识	ydyu
移动硬盘	ydyp
一带一路	ydyl
一代天骄	ydtj
元旦快乐	ydkl
愿赌服输	ydfu
一顿饭功夫	ydff
艺多不压身	ydbu
一大波	ydbo
一动不如一静	ydbj
药到病除	ydbi
言辞凿凿	yczz
要想	ycxl
要是	ycui
要能	ycng
要不	ycbu
拥兵自重	ybzi
一败再败	ybzb
有板有眼	ybyy
咽不下这口气	ybxq
以彼之道还治其人之身	ybvu
音质	ybvi
以暴制暴	ybvb
一把屎一把尿	ybun
仪表堂堂	ybtt
衣不如新，人不如故	ybrg
一表人才	ybrc
犹抱琵琶半遮面	ybpm
一把年纪	ybnj
一边凉快去	yblq
用不了多久	yblj
愚不可及	ybkj
一般见识	ybju
有备而来	ybel
引渡	ybdu
也不错	ybco
一步错，步步错	ybcc
一把鼻涕一把泪	ybbl
因爱生恨	yauh
阴暗面	yamm
啧啧啧	zzze
仄仄平平	zzpp
自作孽不可活	zznh
早有预谋	zyym
座右铭	zymk
自由竞争	zyjv
尊严尽丧	zyjs
自由放任	zyfr
自有分寸	zyfc
作用不大	zybd
自寻短见	zxdj
左问右问	zwyw
自我牺牲	zwxu
自我表现	zwbx
走着走着	zvzv
嘴上	zvuh
增长率	zilv
早知今日，何必当初	zvji
足月	zuyt
资深望重	zuwi
再衰三竭	zcsj
座上客	zuke
左上角	zujn
早上好	zuhc
作声不得	zubd
在天有灵	ztyl
宗门	zsmf
总管	zsgr
纵队	zsdv
总店	zsdm
自然灾害	zrzh
责任心	zrxb
自然规律	zrgl
自强自立	zjzl
在情在理	zqzl
早去早回	zqzh
最起码	zqma
做些	zoso
左派	zopd
怎么做	zmzo
怎么写	zmxp
怎么玩	zmwj
怎么看	zmkj
走马看花	zmkh
怎么查	zmia
怎么搞	zmgc
怎么读	zmdu
坐落在	zlzd
走漏风声	zlfu
再苦再累	zkzl
钻空子	zkzi
坐困愁城	zkii
早就有了	zjyl
早就醒了	zjxl
嘴尖舌头快	zjuk
早就没了	zjml
暂列	zjlp
纵酒欢歌	zjhg
自成一体	ziyt
自修	zixq
自主	zivu
祖传配方	zipf
自建	zijm
综合性	zgxk
杂货铺	zhpu
脏活累活	zhlh
纵横驰骋	zhii
自豪感	zhgj
自顾自	zgzi
锃光瓦亮	zgwl
自古圣贤多寂寞	zgum
总公司	zgsi
自动调频	zddp
坐等其成	zdji
最大努力	zdnl
最大可能	zdkn
自动化	zdhx
早说	zcuo
皂角	zcjn
早会	zchv
早该	zcgd
杂草丛生	zccu
做不了主	zblv
坐不改姓	zbgx
走不动了	zbdl
杂碎	zasv
