曱	zall
甴	gala
叻	likl
冚	hem
氹	dhvu
佢	kvrj
乸	naym
哋	diky
係	xirx
唓	iekl
睇	twop
啲	dikb
嘅	gekv
嗮	sdka
嗰	gokk
嘞	lekl
嘥	sdkr
劏	thxd
劏	tsxd
瞓	ffoi
嘢	yekv
嗻	vekh
瞓	ffol
嬲	nntl
嫐	nznn
嚟	liku
啩	gxkb
啱	ngam
唞	dzkd
踎	mzkk
攞	loff
囖	lokf
吤	gekl
嘅	gekv
咿	yiky
惗	npxx
嘁	qikx
嘚	dekc
嗱	naku
屙	oouk