安全	aq
按照	av
安排	ap
安静	aj
安慰	aw
暧昧	am
按时	au
安逸	ay
昂贵	ag
安定	ad
暗自	az
爱惜	ax
安保	ab
黯然	ar
暗算	as
挨饿	ae
安分	af
按理	al
凹凸	at
拗口	ak
按错	ac
不同	bt
比赛	bs
必须	bx
并且	bq
本来	bl
保证	bv
不再	bz
不然	br
必要	by
不饿	be
背景	bj
才能	cn
从来	cl
采取	cq
聪明	cm
错误	cw
参考	ck
从不	cb
从头	ct
存盘	cp
才行	cx
从前	cq
东西	dx
地方	df
到了	dl
代表	db
代替	dt
得到	dd
电脑	dn
追求	vq
而且	eq
儿子	ez
而已	ey
儿童	et
而不	eb
耳机	ej
恶劣	el
饿死	es
而非	ef
恶搞	eg
额外	ew
二者	ev
噩梦	em
恶毒	ed
恩爱	ea
儿科	ek
儿戏	ex
恩赐	ec
恶评	ep
非常	fi
发现	fx
方面	fm
反正	fv
放弃	fq
方便	fb
反对	fd
反而	fe
反应	fy
分配	fp
烦恼	fn
放松	fs
否认	fr
讽刺	fc
反馈	fk
费了	fl
繁体	ft
否则	fz
附件	fj
分别	fb
过去	gq
根本	gb
功能	gn
过程	gi
沟通	gt
公平	gp
干嘛	gm
公司	gs
刚刚	gg
更新	gx
规则	gz
感觉	gj
回去	hq
后面	hm
害怕	hp
好处	hi
湖南	hn
何必	hb
后天	ht
回复	hf
出现	ix
成为	iw
产品	ip
传统	it
成本	ib
承诺	in
沉默	im
重启	iq
尝尝	ii
程度	id
今天	jt
结果	jg
其中	qv
解决	jj
几乎	jh
简单	jd
期间	qj
奇怪	qg
精彩	jc
简直	jv
计算	js
骄傲	ja
几位	jw
其次	qc
节奏	jz
解放	jf
金额	je
奇偶	jo
绝对	jd
尽管	jg
渐渐	jj
极其	jq
极致	jv
假如	jr
可能	kn
恐怕	kp
看出	ki
恐怖	kb
昆明	km
况且	kq
开头	kt
困难	kn
论坛	lt
了解	lj
联系	lx
浪费	lf
链接	lj
没有	my
目前	mq
明天	mt
明显	mx
美丽	ml
无奈	wn
貌似	ms
无线	wx
默认	mr
明知	mv
每天	mt
慢慢	mm
面前	mq
那些	nx
难道	nd
那样	ny
努力	nl
脑子	nz
欧洲	ov
偶尔	oe
偶像	ox
欧阳	oy
偶然	or
呕吐	ot
殴打	od
漂亮	pl
平台	pt
培训	px
配置	pv
脾气	pq
骗人	pr
拼音	py
配送	ps
普洱	pe
确定	qd
缺乏	qf
亲自	qz
千万	qw
切换	qh
全额	qe
情况	qk
前面	qm
恰恰	qq
日期	rq
认为	rw
日本	rb
人们	rm
容易	ry
人类	rl
认真	rv
热闹	rn
热爱	ra
认可	rk
认同	rt
人品	rp
热线	rx
认得	rd
任务	rw
仍然	rr
所以	sy
似乎	sh
所谓	sw
思想	sx
随便	sb
算了	sl
思考	sk
随你	sn
索赔	sp
洒脱	st
索取	sq
虽然	sr
速度	sd
随着	sv
搜索	ss
同学	tx
特别	tb
台湾	tw
天天	tt
讨论	tl
天气	tq
统一	ty
头发	tf
投资	tz
推荐	tj
淘汰	tt
推倒	td
事情	uq
身体	ut
上面	um
首先	ux
顺便	ub
折腾	vt
神似	us
双拼	up
什么	sm
伤害	uh
世纪	uj
试试	uu
束缚	uf
这样	vy
这么	vm
知道	vd
只能	vn
准备	vb
正确	vq
掌握	vw
咋不	zb
只怕	vp
支持	vi
这些	vx
真正	vv
直到	vd
政府	vf
我们	wm
问题	wt
为了	wl
完全	wq
完成	wi
文字	wz
唯一	wy
微软	wr
为此	wc
为止	wv
玩儿	we
猥琐	ws
五笔	wb
唯恐	wk
网盘	wp
味道	wd
完美	wm
微信	wx
现在	xz
喜欢	xh
需要	xy
希望	xw
习惯	xg
相当	xd
下次	xc
西安	xa
现金	xj
相反	xf
下周	xv
险恶	xe
西欧	xo
选择	xz
学习	xx
下面	xm
修改	xg
修正	xv
因为	yw
一下	yx
应该	yg
一直	yv
要求	yq
一定	yd
原来	yl
一片	yp
郁闷	ym
云南	yn
缘分	yf
与其	yq
悠闲	yx
自己	zj
怎么	zm
昨天	zt
自然	zr
走了	zl
怎样	zy
作品	zp
在线	zx
怎能	zn
暂且	zq
最快	zk
总算	zs
